Elisabeth	NP	Elisabeth
Stern	NP	Stern
,	,	,
a	DT	a
member	NN	member
of	IN	of
the	DT	the
Swiss	JJ	Swiss
Senior	JJ	Senior
Women	NNS	woman
for	IN	for
Climate	NN	climate
Protection	NP	Protection
,	,	,
has	VBZ	have
voiced	VBN	voice
strong	JJ	strong
outrage	NN	outrage
over	IN	over
the	DT	the
condemnation	NN	condemnation
faced	VBN	face
by	IN	by
young	JJ	young
climate	NN	climate
activists	NNS	activist
,	,	,
even	RB	even
as	IN	as
those	DT	those
profiting	VBG	profit
from	IN	from
fossil	JJ	fossil
fuels	NNS	fuel
continue	VBP	continue
to	TO	to
thrive	VB	thrive
without	IN	without
repercussions	NNS	repercussion
.	SENT	.
She	PP	she
points	VBZ	point
out	RP	out
the	DT	the
growing	VBG	grow
pessimism	NN	pessimism
among	IN	among
young	JJ	young
people	NNS	people
regarding	VBG	regard
their	PP$	their
ability	NN	ability
to	TO	to
adapt	VB	adapt
to	TO	to
the	DT	the
impacts	NNS	impact
of	IN	of
climate	NN	climate
change	NN	change
,	,	,
and	CC	and
she	PP	she
underscores	VBZ	underscore
their	PP$	their
urgent	JJ	urgent
pleas	NNS	plea
for	IN	for
action	NN	action
that	IN	that
bridges	NNS	bridge
generations	NNS	generation
.	SENT	.
Motivated	VBN	motivate
not	RB	not
by	IN	by
her	PP$	her
own	JJ	own
survival	NN	survival
but	CC	but
by	IN	by
deep	JJ	deep
concern	NN	concern
for	IN	for
the	DT	the
generations	NNS	generation
to	TO	to
come	VB	come
,	,	,
Stern	NP	Stern
shares	VBZ	share
her	PP$	her
personal	JJ	personal
commitment	NN	commitment
to	TO	to
this	DT	this
cause	NN	cause
,	,	,
which	WDT	which
dates	VBZ	date
back	RB	back
to	TO	to
1977	CD	@card@
.	SENT	.
She	PP	she
emphasizes	VBZ	emphasize
the	DT	the
power	NN	power
of	IN	of
climate	NN	climate
litigation	NN	litigation
as	IN	as
a	DT	a
means	VBZ	mean
to	TO	to
hold	VB	hold
both	DT	both
states	NNS	state
and	CC	and
companies	NNS	company
accountable	JJ	accountable
for	IN	for
their	PP$	their
roles	NNS	role
in	IN	in
the	DT	the
crisis	NN	crisis
.	SENT	.
The	DT	the
group	NN	group
's	POS	's
ongoing	JJ	ongoing
lawsuit	NN	lawsuit
before	IN	before
the	DT	the
European	NP	European
Court	NP	Court
of	IN	of
Human	NP	Human
Rights	NPS	Rights
aims	VBZ	aim
to	TO	to
establish	VB	establish
climate	NN	climate
protection	NN	protection
as	IN	as
a	DT	a
fundamental	JJ	fundamental
human	JJ	human
right	NN	right
,	,	,
a	DT	a
step	NN	step
that	WDT	that
would	MD	would
particularly	RB	particularly
support	VB	support
young	JJ	young
people	NNS	people
grappling	VBG	grapple
with	IN	with
profound	JJ	profound
existential	JJ	existential
concerns	NNS	concern
about	IN	about
the	DT	the
future	NN	future
.	SENT	.
