Thai	JJ	Thai
mackerel	NN	mackerel
,	,	,
which	WDT	which
was	VBD	be
once	RB	once
abundant	JJ	abundant
and	CC	and
affordable	JJ	affordable
in	IN	in
Thailand	NP	Thailand
,	,	,
has	VBZ	have
become	VBN	become
scarce	JJ	scarce
due	RB	due
to	TO	to
unregulated	JJ	unregulated
overfishing	NN	overfishing
of	IN	of
juveniles	NNS	juvenile
.	SENT	.
Catches	NNS	catch
in	IN	in
2020	CD	@card@
were	VBD	be
ten	CD	ten
times	NNS	time
lower	JJR	low
than	IN	than
in	IN	in
2014	CD	@card@
.	SENT	.
The	DT	the
fish	NN	fish
that	WDT	that
remain	VBP	remain
are	VBP	be
smaller	JJR	small
,	,	,
often	RB	often
imported	VBN	import
,	,	,
and	CC	and
more	RBR	more
expensive	JJ	expensive
,	,	,
which	WDT	which
threatens	VBZ	threaten
food	NN	food
security	NN	security
for	IN	for
the	DT	the
poor	JJ	poor
.	SENT	.
Local	JJ	local
fishers	NNS	fisher
from	IN	from
23	CD	@card@
provinces	NNS	province
have	VBP	have
campaigned	VBN	campaign
against	IN	against
the	DT	the
catching	VBG	catch
of	IN	of
juveniles	NNS	juvenile
.	SENT	.
They	PP	they
have	VBP	have
established	VBN	establish
nurseries	NNS	nursery
and	CC	and
urged	VBD	urge
supermarkets	NNS	supermarket
to	TO	to
stop	VB	stop
sales	NNS	sale
of	IN	of
these	DT	these
young	JJ	young
fish	NN	fish
.	SENT	.
The	DT	the
fishers	NNS	fisher
organized	VBD	organize
the	DT	the
"	``	"
Reclaim	NN	reclaim
Mackerel	NN	mackerel
Chili	NP	Chili
Paste	NN	paste
"	``	"
voyage	NN	voyage
,	,	,
sailing	VBG	sail
over	IN	over
1,000	CD	@card@
km	NN	km
from	IN	from
Pattani	NP	<unknown>
to	TO	to
Bangkok	NP	Bangkok
's	POS	's
parliament	NN	parliament
on	IN	on
World	NP	World
Oceans	NNS	ocean
Day	NN	day
.	SENT	.
Their	PP$	their
demand	NN	demand
was	VBD	be
for	IN	for
the	DT	the
enforcement	NN	enforcement
of	IN	of
Section	NP	Section
57	CD	@card@
of	IN	of
the	DT	the
Fisheries	NNS	fishery
Act	NN	act
.	SENT	.
Media	NNS	medium
coverage	NN	coverage
of	IN	of
the	DT	the
voyage	NN	voyage
raised	VBD	raise
awareness	NN	awareness
and	CC	and
prompted	VBD	prompt
a	DT	a
promise	NN	promise
from	IN	from
the	DT	the
government	NN	government
.	SENT	.
However	RB	however
,	,	,
no	DT	no
action	NN	action
has	VBZ	have
followed	VBN	follow
,	,	,
leading	VBG	lead
the	DT	the
fishers	NNS	fisher
to	TO	to
issue	VB	issue
a	DT	a
60-day	JJ	60-day
ultimatum	NN	ultimatum
.	SENT	.
