In	IN	in
recent	JJ	recent
years	NNS	year
,	,	,
we	PP	we
've	VBP	have
seen	VBN	see
how	WRB	how
climate	NN	climate
catastrophes	NNS	catastrophe
and	CC	and
the	DT	the
ongoing	JJ	ongoing
pandemic	NN	pandemic
have	VBP	have
laid	VBN	lay
bare	JJ	bare
deep	JJ	deep
structural	JJ	structural
inequalities	NNS	inequality
across	IN	across
societies	NNS	society
.	SENT	.
These	DT	these
crises	NNS	crisis
disproportionately	RB	disproportionately
affect	VB	affect
marginalized	VBN	marginalize
communities	NNS	community
,	,	,
revealing	VBG	reveal
the	DT	the
urgent	JJ	urgent
need	NN	need
for	IN	for
systemic	JJ	systemic
change	NN	change
.	SENT	.
That	DT	that
's	VBZ	be
why	WRB	why
we	PP	we
must	MD	must
push	VB	push
for	IN	for
stringent	JJ	stringent
regulation	NN	regulation
in	IN	in
key	JJ	key
sectors	NNS	sector
such	JJ	such
as	IN	as
agriculture	NN	agriculture
and	CC	and
energy	NN	energy
.	SENT	.
These	DT	these
regulations	NNS	regulation
should	MD	should
be	VB	be
grounded	VBN	ground
in	IN	in
human	JJ	human
rights	NNS	right
principles	NNS	principle
,	,	,
thorough	JJ	thorough
environmental	JJ	environmental
assessments	NNS	assessment
,	,	,
and	CC	and
the	DT	the
explicit	JJ	explicit
consent	NN	consent
of	IN	of
women	NNS	woman
and	CC	and
Indigenous	JJ	indigenous
Peoples	NPS	Peoples
,	,	,
ensuring	VBG	ensure
that	IN	that
decisions	NNS	decision
respect	VB	respect
those	DT	those
most	RBS	most
impacted	VBN	impact
.	SENT	.
At	IN	at
the	DT	the
same	JJ	same
time	NN	time
,	,	,
it	PP	it
's	VBZ	be
critical	JJ	critical
to	TO	to
call	VB	call
out	RP	out
wealthy	JJ	wealthy
nations	NNS	nation
and	CC	and
corporations	NNS	corporation
for	IN	for
their	PP$	their
profiteering	VBG	profiteer
during	IN	during
these	DT	these
crises	NNS	crisis
.	SENT	.
They	PP	they
've	VBP	have
often	RB	often
prioritized	VBN	<unknown>
gains	NNS	gain
over	IN	over
people	NNS	people
and	CC	and
the	DT	the
planet	NN	planet
,	,	,
exacerbating	VBG	exacerbate
the	DT	the
very	JJ	very
problems	NNS	problem
we	PP	we
're	VBP	be
facing	VBG	face
.	SENT	.
This	DT	this
moment	NN	moment
demands	VBZ	demand
bold	JJ	bold
alternatives	NNS	alternative
to	TO	to
capitalism	NN	capitalism
itself	PP	itself
.	SENT	.
We	PP	we
need	VBP	need
to	TO	to
embrace	VB	embrace
diverse	JJ	diverse
visions	NNS	vision
that	WDT	that
move	VBP	move
beyond	IN	beyond
GDP	NP	GDP
as	IN	as
the	DT	the
sole	JJ	sole
measure	NN	measure
of	IN	of
success	NN	success
,	,	,
focusing	VBG	focus
instead	RB	instead
on	IN	on
wellbeing	NN	wellbeing
for	IN	for
all	DT	all
.	SENT	.
Models	NNS	model
like	IN	like
the	DT	the
Economy	NN	economy
for	IN	for
the	DT	the
Common	JJ	common
Good	JJ	good
matrix	NN	matrix
offer	NN	offer
promising	VBG	promise
frameworks	NNS	framework
that	WDT	that
center	VBP	center
collective	JJ	collective
welfare	NN	welfare
.	SENT	.
To	TO	to
build	VB	build
a	DT	a
just	RB	just
future	JJ	future
,	,	,
we	PP	we
advocate	VBP	advocate
for	IN	for
divesting	VBG	divest
from	IN	from
fossil	JJ	fossil
fuels	NNS	fuel
and	CC	and
military	JJ	military
systems	NNS	system
that	IN	that
fuel	NN	fuel
destruction	NN	destruction
.	SENT	.
We	PP	we
also	RB	also
recognize	VBP	recognize
care	NN	care
work—often	NN	<unknown>
undervalued—as	NNS	<unknown>
essential	JJ	essential
green	JJ	green
jobs	NNS	job
that	WDT	that
sustain	VBP	sustain
communities	NNS	community
and	CC	and
the	DT	the
environment	NN	environment
.	SENT	.
Finally	RB	finally
,	,	,
redistributing	VBG	redistribute
power	NN	power
away	RB	away
from	IN	from
corporations	NNS	corporation
is	VBZ	be
key	JJ	key
.	SENT	.
This	DT	this
can	MD	can
be	VB	be
achieved	VBN	achieve
through	IN	through
strong	JJ	strong
accountability	NN	accountability
measures	NNS	measure
,	,	,
including	VBG	include
a	DT	a
binding	JJ	binding
international	JJ	international
treaty	NN	treaty
to	TO	to
hold	VB	hold
them	PP	them
responsible	JJ	responsible
and	CC	and
ensure	VB	ensure
equitable	JJ	equitable
outcomes	NNS	outcome
.	SENT	.
