In	IN	in
Chile	NP	Chile
,	,	,
Greenpeace	NP	Greenpeace
's	POS	's
Roots	NP	Roots
project	NN	project
teamed	VBD	team
up	RP	up
with	IN	with
local	JJ	local
communities	NNS	community
,	,	,
MODATIMA	NP	<unknown>
Women	NP	Women
,	,	,
and	CC	and
Finland	NP	Finland
's	POS	's
Sibelius	NP	Sibelius
Music	NP	Music
Academy	NP	Academy
to	TO	to
produce	VB	produce
"	``	"
Canto	NP	Canto
del	NP	del
Agua	NP	Agua
,	,	,
"	''	"
a	DT	a
collective	JJ	collective
song	NN	song
that	WDT	that
protests	VBZ	protest
water	NN	water
privatization	NN	privatization
.	SENT	.
The	DT	the
initiative	NN	initiative
took	VBD	take
place	NN	place
through	IN	through
a	DT	a
workshop	NN	workshop
in	IN	in
La	NP	La
Ligua	NP	<unknown>
,	,	,
set	VBN	set
against	IN	against
the	DT	the
backdrop	NN	backdrop
of	IN	of
the	DT	the
country	NN	country
's	POS	's
severe	JJ	severe
water	NN	water
crisis	NN	crisis
,	,	,
which	WDT	which
stems	VBZ	stem
from	IN	from
looting	VBG	loot
rather	RB	rather
than	IN	than
just	RB	just
drought	NN	drought
.	SENT	.
Musicians	NNS	musician
and	CC	and
activists	NNS	activist
came	VBD	come
together	RB	together
to	TO	to
share	VB	share
their	PP$	their
personal	JJ	personal
stories	NNS	story
of	IN	of
family	NN	family
devastation	NN	devastation
,	,	,
migration	NN	migration
,	,	,
and	CC	and
territorial	JJ	territorial
destruction	NN	destruction
caused	VBN	cause
by	IN	by
these	DT	these
issues	NNS	issue
.	SENT	.
The	DT	the
workshop	NN	workshop
featured	VBD	feature
activities	NNS	activity
like	IN	like
sound	JJ	sound
collection	NN	collection
,	,	,
rhythmic	JJ	rhythmic
improvisation	NN	improvisation
,	,	,
and	CC	and
co-creation	NN	co-creation
,	,	,
fostering	VBG	foster
a	DT	a
collaborative	JJ	collaborative
environment	NN	environment
.	SENT	.
The	DT	the
effort	NN	effort
peaked	VBN	peak
with	IN	with
a	DT	a
concert	NN	concert
held	VBN	hold
on	IN	on
World	NP	World
Day	NP	Day
to	TO	to
Combat	VB	combat
Desertification	NN	desertification
and	CC	and
Drought	NN	drought
.	SENT	.
Afterward	RB	afterward
,	,	,
the	DT	the
song	NN	song
was	VBD	be
recorded	VBN	record
for	IN	for
digital	JJ	digital
promotion	NN	promotion
,	,	,
positioning	VBG	position
it	PP	it
as	IN	as
an	DT	an
anthem	NN	anthem
advocating	VBG	advocate
for	IN	for
the	DT	the
de-privatization	NN	de-privatization
of	IN	of
water	NN	water
.	SENT	.
