The	DT	the
Netflix	NP	<unknown>
film	NN	film
"	``	"
Do	VBP	do
nâ€™t	RB	n't
Look	VB	look
Up	RP	up
"	``	"
serves	VBZ	serve
as	IN	as
a	DT	a
satirical	JJ	satirical
metaphor	NN	metaphor
for	IN	for
the	DT	the
climate	NN	climate
crisis	NN	crisis
.	SENT	.
It	PP	it
has	VBZ	have
achieved	VBN	achieve
record-breaking	JJ	record-breaking
viewership	NN	viewership
and	CC	and
has	VBZ	have
sparked	VBN	spark
divisive	JJ	divisive
opinions	NNS	opinion
.	SENT	.
The	DT	the
film	NN	film
uses	VBZ	use
humor	NN	humor
to	TO	to
expose	VB	expose
societal	JJ	societal
denial	NN	denial
,	,	,
biases	NNS	bias
,	,	,
and	CC	and
communication	NN	communication
failures	NNS	failure
.	SENT	.
It	PP	it
can	MD	can
be	VB	be
compared	VBN	compare
to	TO	to
influential	JJ	influential
socially	RB	socially
relevant	JJ	relevant
movies	NNS	movie
.	SENT	.
Insights	NNS	insight
from	IN	from
ecologist	NN	ecologist
Nora	NP	Nora
Bateson	NP	Bateson
highlight	NN	highlight
satire	NN	satire
as	IN	as
play	NN	play
that	WDT	that
reveals	VBZ	reveal
deeper	JJR	deep
truths	NNS	truth
and	CC	and
blind	JJ	blind
spots	NNS	spot
.	SENT	.
The	DT	the
film	NN	film
acts	VBZ	act
as	IN	as
a	DT	a
"	``	"
mind	NN	mind
bomb	NN	bomb
"	''	"
to	TO	to
shift	VB	shift
perceptions	NNS	perception
.	SENT	.
It	PP	it
urges	VBZ	urge
examination	NN	examination
of	IN	of
broader	JJR	broad
ecological	JJ	ecological
overshoot	VBP	overshoot
beyond	IN	beyond
climate	NN	climate
,	,	,
including	VBG	include
population	NN	population
and	CC	and
consumption	NN	consumption
issues	NNS	issue
.	SENT	.
The	DT	the
film	NN	film
has	VBZ	have
received	VBN	receive
mixed	JJ	mixed
reviews	NNS	review
along	IN	along
ideological	JJ	ideological
lines	NNS	line
.	SENT	.
