In	IN	in
our	PP$	our
increasingly	RB	increasingly
interconnected	VBN	interconnect
world	NN	world
,	,	,
the	DT	the
global	JJ	global
food	NN	food
system	NN	system
is	VBZ	be
fundamentally	RB	fundamentally
broken	VBN	break
.	SENT	.
It	PP	it
undermines	VBZ	undermine
human	JJ	human
health	NN	health
,	,	,
devastates	VBZ	devastate
the	DT	the
environment	NN	environment
,	,	,
and	CC	and
deepens	VBZ	deepen
inequality	NN	inequality
,	,	,
all	RB	all
while	IN	while
vast	JJ	vast
amounts	NNS	amount
of	IN	of
food	NN	food
go	VBP	go
to	TO	to
waste	VB	waste
even	RB	even
as	IN	as
hunger	NN	hunger
affects	VBZ	affect
millions	NNS	million
.	SENT	.
Amid	IN	amid
these	DT	these
challenges	NNS	challenge
,	,	,
inspiring	JJ	inspiring
stories	NNS	story
of	IN	of
community	NN	community
action	NN	action
offer	NN	offer
hope	NN	hope
.	SENT	.
In	IN	in
Chiang	NP	Chiang
Mai	NP	Mai
,	,	,
Thailand	NP	Thailand
,	,	,
Supawut	NP	<unknown>
Boonmahathanakorn	NP	Boonmahathanakorn
and	CC	and
his	PP$	his
team	NN	team
stepped	VBD	step
up	RP	up
during	IN	during
the	DT	the
Covid-19	NP	<unknown>
pandemic	NN	pandemic
to	TO	to
address	VB	address
food	NN	food
insecurity	NN	insecurity
among	IN	among
the	DT	the
urban	JJ	urban
poor	NN	poor
.	SENT	.
They	PP	they
converted	VBD	convert
a	DT	a
4,800-square-meter	JJ	<unknown>
vacant	JJ	vacant
dumping	VBG	dump
ground	NN	ground
into	IN	into
a	DT	a
thriving	JJ	thriving
urban	JJ	urban
farm	NN	farm
,	,	,
with	IN	with
backing	VBG	back
from	IN	from
the	DT	the
local	JJ	local
community	NN	community
and	CC	and
municipal	JJ	municipal
authorities	NNS	authority
.	SENT	.
Today	NN	today
,	,	,
the	DT	the
farm	NN	farm
produces	VBZ	produce
organic	JJ	organic
crops	NNS	crop
such	JJ	such
as	IN	as
morning	NN	morning
glories	NNS	glory
and	CC	and
corn	NN	corn
.	SENT	.
Harvests	NNS	harvest
are	VBP	be
shared	VBN	share
directly	RB	directly
with	IN	with
those	DT	those
in	IN	in
need	NN	need
,	,	,
while	IN	while
excess	JJ	excess
produce	NN	produce
is	VBZ	be
sold	VBN	sell
to	TO	to
ensure	VB	ensure
the	DT	the
project	NN	project
's	POS	's
long-term	JJ	long-term
sustainability	NN	sustainability
.	SENT	.
The	DT	the
initiative	NN	initiative
also	RB	also
supports	VBZ	support
local	JJ	local
soup	NN	soup
kitchens	NNS	kitchen
and	CC	and
provides	VBZ	provide
spaces	NNS	space
for	IN	for
education	NN	education
,	,	,
showcasing	VBG	showcase
how	WRB	how
grassroots	NNS	grassroots
efforts	NNS	effort
can	MD	can
build	VB	build
food	NN	food
sovereignty	NN	sovereignty
and	CC	and
empower	VB	empower
people	NNS	people
to	TO	to
reclaim	VB	reclaim
control	NN	control
over	IN	over
their	PP$	their
food	NN	food
systems	NNS	system
.	SENT	.
