The	DT	the
climate	NN	climate
crisis	NN	crisis
is	VBZ	be
real	JJ	real
and	CC	and
urgent	JJ	urgent
,	,	,
demanding	VBG	demand
immediate	JJ	immediate
action	NN	action
from	IN	from
all	DT	all
of	IN	of
us	PP	us
.	SENT	.
We	PP	we
must	MD	must
stop	VB	stop
pipelines	NNS	pipeline
through	IN	through
Indigenous-led	JJ	<unknown>
resistance	NN	resistance
,	,	,
standing	VBG	stand
in	IN	in
solidarity	NN	solidarity
with	IN	with
those	DT	those
on	IN	on
the	DT	the
frontlines	NNS	frontline
protecting	VBG	protect
their	PP$	their
lands	NNS	land
and	CC	and
our	PP$	our
shared	JJ	shared
future	NN	future
.	SENT	.
To	TO	to
avert	VB	avert
catastrophe	NN	catastrophe
,	,	,
we	PP	we
need	VBP	need
to	TO	to
achieve	VB	achieve
zero	CD	zero
global	JJ	global
emissions	NNS	emission
,	,	,
starting	VBG	start
by	IN	by
halving	VBG	halve
them	PP	them
by	IN	by
2030	CD	@card@
.	SENT	.
Governments	NNS	government
must	MD	must
align	VB	align
their	PP$	their
targets	NNS	target
with	IN	with
1.5Â°C	JJ	<unknown>
limits	NNS	limit
,	,	,
especially	RB	especially
as	IN	as
we	PP	we
approach	VBP	approach
COP26	NP	<unknown>
,	,	,
where	WRB	where
bold	JJ	bold
commitments	NNS	commitment
are	VBP	be
essential	JJ	essential
.	SENT	.
Financial	JJ	financial
institutions	NNS	institution
have	VBP	have
a	DT	a
critical	JJ	critical
role	NN	role
:	:	:
they	PP	they
must	MD	must
divest	VB	divest
from	IN	from
fossil	JJ	fossil
fuels	NNS	fuel
without	IN	without
resorting	VBG	resort
to	TO	to
greenwashing	NN	greenwashing
,	,	,
ensuring	VBG	ensure
their	PP$	their
actions	NNS	action
truly	RB	truly
support	VBP	support
a	DT	a
sustainable	JJ	sustainable
path	NN	path
.	SENT	.
Fixing	VBG	fix
our	PP$	our
broken	VBN	break
food	NN	food
system	NN	system
is	VBZ	be
key	JJ	key
,	,	,
which	WDT	which
means	VBZ	mean
ending	VBG	end
deforestation	NN	deforestation
and	CC	and
promoting	VBG	promote
plant-based	JJ	<unknown>
diets	NNS	diet
to	TO	to
reduce	VB	reduce
emissions	NNS	emission
and	CC	and
preserve	VB	preserve
biodiversity	NN	biodiversity
.	SENT	.
We	PP	we
also	RB	also
need	VBP	need
to	TO	to
transform	VB	transform
transport	NN	transport
systems	NNS	system
to	TO	to
cut	VB	cut
pollution	NN	pollution
and	CC	and
build	VB	build
cleaner	JJR	clean
alternatives	NNS	alternative
.	SENT	.
Protecting	VBG	protect
at	IN	at
least	JJS	least
30	CD	@card@
%	NN	%
of	IN	of
ecosystems	NNS	ecosystem
worldwide	RB	worldwide
is	VBZ	be
vital	JJ	vital
for	IN	for
maintaining	VBG	maintain
the	DT	the
planet	NN	planet
's	POS	's
health	NN	health
and	CC	and
resilience	NN	resilience
.	SENT	.
Supporting	VBG	support
Indigenous	JJ	indigenous
rights	NNS	right
is	VBZ	be
non-negotiable	JJ	non-negotiable
,	,	,
recognizing	VBG	recognize
their	PP$	their
leadership	NN	leadership
in	IN	in
environmental	JJ	environmental
stewardship	NN	stewardship
.	SENT	.
As	IN	as
we	PP	we
prepare	VBP	prepare
for	IN	for
the	DT	the
impacts	NNS	impact
of	IN	of
climate	NN	climate
change	NN	change
,	,	,
we	PP	we
must	MD	must
do	VB	do
so	RB	so
justly	RB	justly
,	,	,
applying	VBG	apply
the	DT	the
polluter	NN	polluter
pays	VBZ	pay
principle	NN	principle
to	TO	to
hold	VB	hold
those	DT	those
responsible	JJ	responsible
accountable	JJ	accountable
.	SENT	.
Solidarity	NP	Solidarity
is	VBZ	be
crucial	JJ	crucial
,	,	,
delivered	VBN	deliver
through	IN	through
robust	JJ	robust
climate	NN	climate
finance	NN	finance
to	TO	to
support	VB	support
vulnerable	JJ	vulnerable
communities	NNS	community
globally	RB	globally
.	SENT	.
We	PP	we
advocate	VBP	advocate
for	IN	for
a	DT	a
just	JJ	just
transition	NN	transition
away	RB	away
from	IN	from
fossil	JJ	fossil
fuels	NNS	fuel
,	,	,
with	IN	with
no	DT	no
new	JJ	new
investments	NNS	investment
in	IN	in
this	DT	this
destructive	JJ	destructive
industry	NN	industry
.	SENT	.
Finally	RB	finally
,	,	,
we	PP	we
can	MD	can
leverage	VB	leverage
the	DT	the
COVID-19	NP	<unknown>
recovery	NN	recovery
for	IN	for
a	DT	a
green	JJ	green
future	NN	future
,	,	,
powered	VBN	power
by	IN	by
people	NNS	people
coming	VBG	come
together	RB	together
to	TO	to
demand	VB	demand
and	CC	and
drive	VB	drive
change	NN	change
.	SENT	.
