In	IN	in
May	NP	May
,	,	,
Greenpeace	NP	Greenpeace
International	NP	International
hosted	VBD	host
a	DT	a
live	JJ	live
conversation	NN	conversation
focused	VBN	focus
on	IN	on
extractivism	NN	extractivism
in	IN	in
Latin	NP	Latin
America	NP	America
and	CC	and
the	DT	the
powerful	JJ	powerful
community	NN	community
resistance	NN	resistance
against	IN	against
it	PP	it
.	SENT	.
The	DT	the
event	NN	event
featured	VBD	feature
Rosario	NP	Rosario
Coll	NP	Coll
and	CC	and
Sophie	NP	Sophie
Schroder	NP	Schroder
from	IN	from
Greenpeace	NP	Greenpeace
's	POS	's
Collective	JJ	collective
Climate	NN	climate
Action	NP	Action
project	NN	project
,	,	,
who	WP	who
contributed	VBD	contribute
to	TO	to
the	DT	the
discussion	NN	discussion
.	SENT	.
As	IN	as
part	NN	part
of	IN	of
our	PP$	our
Roundtable	NP	Roundtable
Discussion	NN	discussion
series	NN	series
,	,	,
the	DT	the
conversation	NN	conversation
was	VBD	be
moderated	VBN	moderate
by	IN	by
journalist	NN	journalist
Stefanía	NP	<unknown>
Dommarco	NP	Dommarco
.	SENT	.
The	DT	the
panel	NN	panel
included	VBD	include
Gustavo	NP	Gustavo
Huici	NP	<unknown>
,	,	,
Riccardo	NP	Riccardo
Tiddi	NP	<unknown>
,	,	,
Juan	NP	Juan
Sarmiento	NP	Sarmiento
Lobo	NP	Lobo
,	,	,
Lorena	NP	Lorena
Donaire	NP	<unknown>
,	,	,
and	CC	and
Alejandra	NP	Alejandra
Jiménez	NP	<unknown>
Ramírez	NP	<unknown>
,	,	,
who	WP	who
shared	VBD	share
their	PP$	their
firsthand	JJ	firsthand
experiences	NNS	experience
in	IN	in
combating	VBG	combat
deep	JJ	deep
sea	NN	sea
oil	NN	oil
exploration	NN	exploration
,	,	,
deforestation	NN	deforestation
,	,	,
mining	NN	mining
,	,	,
water	NN	water
access	NN	access
issues	NNS	issue
,	,	,
and	CC	and
fracking	NN	<unknown>
.	SENT	.
Throughout	IN	throughout
the	DT	the
discussion	NN	discussion
,	,	,
participants	NNS	participant
emphasized	VBD	emphasize
Latin	NP	Latin
America	NP	America
's	POS	's
position	NN	position
as	IN	as
a	DT	a
key	JJ	key
environmental	JJ	environmental
battleground	NN	battleground
.	SENT	.
They	PP	they
explored	VBD	explore
how	WRB	how
these	DT	these
struggles	NNS	struggle
intertwine	VBP	intertwine
with	IN	with
broader	JJR	broad
fights	NNS	fight
for	IN	for
sovereignty	NN	sovereignty
,	,	,
equity	NN	equity
,	,	,
human	JJ	human
rights	NNS	right
,	,	,
and	CC	and
alliances	NNS	alliance
within	IN	within
global	JJ	global
movements	NNS	movement
,	,	,
all	RB	all
in	IN	in
the	DT	the
context	NN	context
of	IN	of
the	DT	the
ongoing	JJ	ongoing
climate	NN	climate
crisis	NN	crisis
.	SENT	.
