The	DT	the
fragility	NN	fragility
of	IN	of
life	NN	life
has	VBZ	have
been	VBN	be
starkly	RB	starkly
revealed	VBN	reveal
through	IN	through
events	NNS	event
like	IN	like
the	DT	the
COVID-19	NP	<unknown>
pandemic	NN	pandemic
,	,	,
as	RB	as
highlighted	VBN	highlight
in	IN	in
a	DT	a
blog	NN	<unknown>
post	NN	post
by	IN	by
SÃ´nia	NP	<unknown>
Guajajara	NP	<unknown>
.	SENT	.
She	PP	she
urges	VBZ	urge
immediate	JJ	immediate
care	NN	care
for	IN	for
Mother	NP	Mother
Earth	NP	Earth
to	TO	to
prevent	VB	prevent
new	JJ	new
pandemics	NNS	pandemic
arising	VBG	arise
from	IN	from
biodiversity	NN	biodiversity
destruction	NN	destruction
.	SENT	.
Indigenous	JJ	indigenous
Peoples	NPS	Peoples
warn	VBP	warn
that	IN	that
human	JJ	human
life	NN	life
is	VBZ	be
deeply	RB	deeply
interconnected	VBN	interconnect
with	IN	with
nature	NN	nature
,	,	,
and	CC	and
predatory	JJ	predatory
economic	JJ	economic
models	NNS	model
put	VBD	put
everyone	NN	everyone
's	POS	's
future	NN	future
at	IN	at
risk	NN	risk
.	SENT	.
Since	IN	since
colonial	JJ	colonial
invasions	NNS	invasion
,	,	,
Brazilian	JJ	Brazilian
Indigenous	JJ	indigenous
groups	NNS	group
have	VBP	have
adapted	VBN	adapt
their	PP$	their
strategies	NNS	strategy
to	TO	to
fight	VB	fight
for	IN	for
their	PP$	their
rights	NNS	right
,	,	,
making	VBG	make
use	NN	use
of	IN	of
the	DT	the
Constitution	NP	Constitution
in	IN	in
their	PP$	their
efforts	NNS	effort
.	SENT	.
In	IN	in
a	DT	a
significant	JJ	significant
step	NN	step
,	,	,
the	DT	the
Articulation	NN	articulation
of	IN	of
Indigenous	JJ	indigenous
Peoples	NPS	Peoples
of	IN	of
Brazil	NP	Brazil
(	(	(
APIB	NP	<unknown>
)	)	)
,	,	,
together	RB	together
with	IN	with
allies	NNS	ally
such	JJ	such
as	IN	as
Greenpeace	NP	Greenpeace
Brazil	NP	Brazil
and	CC	and
political	JJ	political
parties	NNS	party
,	,	,
has	VBZ	have
filed	VBN	file
a	DT	a
case	NN	case
in	IN	in
the	DT	the
Supreme	NP	Supreme
Court	NP	Court
.	SENT	.
This	DT	this
action	NN	action
aims	VBZ	aim
to	TO	to
compel	VB	compel
the	DT	the
government	NN	government
to	TO	to
protect	VB	protect
the	DT	the
Amazon	NN	Amazon
,	,	,
forests	NNS	forest
,	,	,
waters	NNS	water
,	,	,
and	CC	and
all	DT	all
forms	NNS	form
of	IN	of
life	NN	life
.	SENT	.
