As	IN	as
the	DT	the
COVID-19	NP	<unknown>
pandemic	NN	pandemic
continues	VBZ	continue
to	TO	to
unfold	VB	unfold
,	,	,
we	PP	we
've	VBP	have
seen	VBN	see
an	DT	an
alarming	JJ	alarming
rise	NN	rise
in	IN	in
discarded	VBN	discard
disposable	JJ	disposable
face	NN	face
masks	NNS	mask
washing	VBG	wash
up	RP	up
on	IN	on
coasts	NNS	coast
and	CC	and
beaches	NNS	beach
around	IN	around
the	DT	the
world	NN	world
,	,	,
including	VBG	include
right	RB	right
here	RB	here
in	IN	in
Taiwan	NP	Taiwan
.	SENT	.
These	DT	these
single-use	NN	<unknown>
items	NNS	item
,	,	,
essential	JJ	essential
for	IN	for
public	JJ	public
health	NN	health
,	,	,
are	VBP	be
now	RB	now
contributing	VBG	contribute
to	TO	to
a	DT	a
growing	VBG	grow
environmental	JJ	environmental
crisis	NN	crisis
.	SENT	.
From	IN	from
February	NP	February
to	TO	to
May	NP	May
alone	RB	alone
,	,	,
Taiwan	NP	Taiwan
consumed	VBD	consume
an	DT	an
estimated	VBN	estimate
1.3	CD	@card@
billion	NN	billion
masks	NNS	mask
,	,	,
resulting	VBG	result
in	IN	in
about	RB	about
5,500	CD	@card@
tonnes	NNS	tonne
of	IN	of
waste	NN	waste
.	SENT	.
While	IN	while
masks	NNS	mask
used	VBN	use
in	IN	in
medical	JJ	medical
settings	NNS	setting
are	VBP	be
handled	VBN	handle
through	IN	through
proper	JJ	proper
waste	NN	waste
management	NN	management
protocols	NNS	protocol
,	,	,
those	DT	those
worn	JJ	worn
by	IN	by
the	DT	the
general	JJ	general
public	NN	public
often	RB	often
end	VB	end
up	RP	up
in	IN	in
a	DT	a
regulatory	JJ	regulatory
grey	NN	grey
area	NN	area
.	SENT	.
Due	JJ	due
to	TO	to
potential	JJ	potential
contamination	NN	contamination
risks	NNS	risk
,	,	,
these	DT	these
masks	NNS	mask
cannot	MD	can
be	VB	be
recycled	VBN	recycle
,	,	,
leading	VBG	lead
to	TO	to
improper	JJ	improper
disposal	NN	disposal
and	CC	and
littering	VBG	litter
.	SENT	.
The	DT	the
consequences	NNS	consequence
are	VBP	be
severe	JJ	severe
:	:	:
masks	NNS	mask
made	VBN	make
from	IN	from
materials	NNS	material
like	IN	like
polypropylene	NN	polypropylene
break	NN	break
down	RB	down
over	IN	over
time	NN	time
,	,	,
releasing	VBG	release
microplastics	NNS	microplastic
that	WDT	that
threaten	VBP	threaten
ecosystems	NNS	ecosystem
and	CC	and
marine	JJ	marine
life	NN	life
.	SENT	.
Animals	NNS	animal
can	MD	can
become	VB	become
entangled	JJ	entangled
in	IN	in
the	DT	the
straps	NNS	strap
or	CC	or
ingest	VB	ingest
the	DT	the
debris	NN	debris
,	,	,
disrupting	VBG	disrupt
fragile	JJ	fragile
ocean	NN	ocean
habitats	NNS	habitat
.	SENT	.
In	IN	in
response	NN	response
,	,	,
the	DT	the
Taiwanese	JJ	Taiwanese
government	NN	government
has	VBZ	have
stepped	VBN	step
up	RP	up
efforts	NNS	effort
with	IN	with
public	JJ	public
education	NN	education
campaigns	NNS	campaign
and	CC	and
fines	NNS	fine
for	IN	for
littering	VBG	litter
to	TO	to
curb	VB	curb
the	DT	the
problem	NN	problem
.	SENT	.
At	IN	at
Greenpeace	NP	Greenpeace
Taiwan	NP	Taiwan
,	,	,
we	PP	we
're	VBP	be
urging	VBG	urge
the	DT	the
development	NN	development
of	IN	of
comprehensive	JJ	comprehensive
guidelines	NNS	guideline
for	IN	for
single-use	JJ	<unknown>
personal	JJ	personal
protective	JJ	protective
equipment	NN	equipment
(	(	(
PPE	NP	PPE
)	)	)
that	WDT	that
prioritize	VBP	<unknown>
both	DT	both
human	JJ	human
health	NN	health
and	CC	and
environmental	JJ	environmental
sustainability	NN	sustainability
.	SENT	.
This	DT	this
builds	VBZ	build
on	IN	on
our	PP$	our
longstanding	JJ	longstanding
advocacy	NN	advocacy
to	TO	to
reduce	VB	reduce
plastic	JJ	plastic
pollution	NN	pollution
overall	NN	overall
,	,	,
ensuring	VBG	ensure
that	IN	that
our	PP$	our
fight	NN	fight
against	IN	against
the	DT	the
pandemic	NN	pandemic
does	VBZ	do
n't	RB	n't
come	VB	come
at	IN	at
the	DT	the
expense	NN	expense
of	IN	of
the	DT	the
planet	NN	planet
.	SENT	.
