The	DT	the
coronavirus	NN	coronavirus
pandemic	NN	pandemic
has	VBZ	have
thrust	VBN	thrust
humanity	NN	humanity
into	IN	into
a	DT	a
series	NN	series
of	IN	of
profound	JJ	profound
dilemmas	NNS	dilemma
,	,	,
which	WDT	which
can	MD	can
be	VB	be
understood	VBN	understand
through	IN	through
Gregory	NP	Gregory
Bateson	NP	Bateson
's	POS	's
concept	NN	concept
of	IN	of
the	DT	the
"	``	"
double	JJ	double
bind	NN	bind
.	SENT	.
"	''	"
This	DT	this
idea	NN	idea
describes	VBZ	describe
situations	NNS	situation
where	WRB	where
individuals	NNS	individual
or	CC	or
societies	NNS	society
face	VBP	face
conflicting	JJ	conflicting
demands	NNS	demand
that	WDT	that
cannot	MD	can
be	VB	be
resolved	VBN	resolve
within	IN	within
the	DT	the
existing	JJ	existing
framework	NN	framework
,	,	,
leading	VBG	lead
to	TO	to
paralysis	NN	paralysis
or	CC	or
breakdown	NN	breakdown
.	SENT	.
In	IN	in
the	DT	the
case	NN	case
of	IN	of
the	DT	the
pandemic	NN	pandemic
,	,	,
one	CD	one
such	JJ	such
double	JJ	double
bind	NN	bind
involves	VBZ	involve
the	DT	the
tension	NN	tension
between	IN	between
preventing	VBG	prevent
economic	JJ	economic
collapse	NN	collapse
and	CC	and
mitigating	JJ	mitigating
health	NN	health
risks	NNS	risk
,	,	,
where	WRB	where
actions	NNS	action
to	TO	to
save	VB	save
lives	NNS	life
often	RB	often
exacerbate	VBP	exacerbate
financial	JJ	financial
hardships	NNS	hardship
,	,	,
and	CC	and
vice	JJ	vice
versa	RB	versa
.	SENT	.
This	DT	this
pattern	NN	pattern
extends	VBZ	extend
beyond	IN	beyond
the	DT	the
immediate	JJ	immediate
crisis	NN	crisis
,	,	,
reflecting	VBG	reflect
how	WRB	how
unchecked	JJ	unchecked
human	JJ	human
growth	NN	growth
drives	VBZ	drive
broader	JJR	broad
ecological	JJ	ecological
crises	NNS	crisis
.	SENT	.
The	DT	the
relentless	JJ	relentless
pursuit	NN	pursuit
of	IN	of
expansion	NN	expansion
contributes	VBZ	contribute
to	TO	to
species	NN	species
loss	NN	loss
and	CC	and
global	JJ	global
heating	NN	heating
,	,	,
trapping	VBG	trap
us	PP	us
in	IN	in
systems	NNS	system
that	WDT	that
demand	VBP	demand
perpetual	JJ	perpetual
growth	NN	growth
while	IN	while
undermining	VBG	undermine
the	DT	the
very	JJ	very
foundations	NNS	foundation
of	IN	of
life	NN	life
on	IN	on
Earth	NP	Earth
.	SENT	.
To	TO	to
navigate	VB	navigate
these	DT	these
binds	NNS	bind
,	,	,
solutions	NNS	solution
call	VBP	call
for	IN	for
expanding	VBG	expand
our	PP$	our
awareness	NN	awareness
to	TO	to
encompass	VB	encompass
the	DT	the
entire	JJ	entire
Earth	NN	earth
's	POS	's
biosphere	NN	biosphere
.	SENT	.
This	DT	this
means	VBZ	mean
embracing	VBG	embrace
what	WP	what
can	MD	can
be	VB	be
termed	VBN	term
an	DT	an
Ecological	JJ	ecological
Imperative	NN	imperative
:	:	:
the	DT	the
necessity	NN	necessity
to	TO	to
reduce	VB	reduce
human	JJ	human
population	NN	population
and	CC	and
consumption	NN	consumption
levels	NNS	level
to	TO	to
prevent	VB	prevent
overshoot	VB	overshoot
,	,	,
where	WRB	where
demands	NNS	demand
exceed	VBP	exceed
the	DT	the
planet	NN	planet
's	POS	's
regenerative	JJ	regenerative
capacity	NN	capacity
.	SENT	.
The	DT	the
post-pandemic	JJ	post-pandemic
era	NN	era
offers	VBZ	offer
an	DT	an
opportunity	NN	opportunity
to	TO	to
critique	NN	critique
notions	NNS	notion
like	IN	like
"	``	"
sustainable	JJ	sustainable
growth	NN	growth
"	''	"
and	CC	and
reliance	NN	reliance
on	IN	on
technology	NN	technology
fixes	NNS	fix
,	,	,
which	WDT	which
often	RB	often
perpetuate	VBP	perpetuate
the	DT	the
same	JJ	same
problematic	JJ	problematic
patterns	NNS	pattern
.	SENT	.
Instead	RB	instead
,	,	,
we	PP	we
can	MD	can
learn	VB	learn
from	IN	from
nature	NN	nature
's	POS	's
principles	NNS	principle
of	IN	of
resilience	NN	resilience
,	,	,
localization	NN	localization
,	,	,
and	CC	and
mutual	JJ	mutual
reciprocity—systems	NNS	reciprocity—system
that	WDT	that
thrive	VBP	thrive
through	IN	through
interconnected	VBN	interconnect
,	,	,
adaptive	JJ	adaptive
relationships	NNS	relationship
rather	RB	rather
than	IN	than
dominance	NN	dominance
.	SENT	.
Ultimately	RB	ultimately
,	,	,
this	DT	this
shift	NN	shift
urges	VBZ	urge
us	PP	us
to	TO	to
move	VB	move
toward	IN	toward
respecting	VBG	respect
ecological	JJ	ecological
limits	NNS	limit
,	,	,
fostering	VBG	foster
a	DT	a
flexible	JJ	flexible
approach	NN	approach
without	IN	without
rigid	JJ	rigid
plans	NNS	plan
,	,	,
allowing	VBG	allow
for	IN	for
a	DT	a
more	RBR	more
harmonious	JJ	harmonious
integration	NN	integration
with	IN	with
the	DT	the
natural	JJ	natural
world	NN	world
.	SENT	.
