As	IN	as
the	DT	the
coronavirus	NN	coronavirus
crisis	NN	crisis
unfolds	VBZ	unfold
,	,	,
it	PP	it
's	VBZ	be
a	DT	a
pivotal	JJ	pivotal
moment	NN	moment
to	TO	to
rethink	VB	rethink
how	WRB	how
we	PP	we
allocate	VBP	allocate
public	JJ	public
funds	NNS	fund
.	SENT	.
Instead	RB	instead
of	IN	of
supporting	VBG	support
industries	NNS	industry
that	WDT	that
harm	VBP	harm
the	DT	the
planet	NN	planet
,	,	,
we	PP	we
should	MD	should
redirect	VB	redirect
those	DT	those
resources	NNS	resource
toward	IN	toward
bolstering	VBG	bolster
public	JJ	public
health	NN	health
,	,	,
ensuring	VBG	ensure
planetary	JJ	planetary
well-being	NN	well-being
,	,	,
and	CC	and
enabling	VBG	enable
a	DT	a
just	JJ	just
transition	NN	transition
to	TO	to
a	DT	a
more	RBR	more
harmonious	JJ	harmonious
future	NN	future
by	IN	by
2030	CD	@card@
.	SENT	.
We	PP	we
must	MD	must
be	VB	be
wary	JJ	wary
of	IN	of
the	DT	the
"	``	"
shock	NN	shock
doctrine	NN	doctrine
"	''	"
that	WDT	that
could	MD	could
exploit	VB	exploit
workers	NNS	worker
during	IN	during
this	DT	this
time	NN	time
.	SENT	.
Leaders	NNS	leader
need	VBP	need
to	TO	to
be	VB	be
held	VBN	hold
accountable	JJ	accountable
,	,	,
and	CC	and
our	PP$	our
responses	NNS	response
should	MD	should
prioritize	VB	<unknown>
community	NN	community
,	,	,
cooperation	NN	cooperation
,	,	,
and	CC	and
compassion	NN	compassion
rather	RB	rather
than	IN	than
fostering	VBG	foster
blame	NN	blame
or	CC	or
division	NN	division
.	SENT	.
The	DT	the
choices	NNS	choice
we	PP	we
make	VBP	make
now	RB	now
should	MD	should
focus	VB	focus
on	IN	on
protecting	VBG	protect
the	DT	the
vulnerable	JJ	vulnerable
,	,	,
drawing	VBG	draw
deep	JJ	deep
lessons	NNS	lesson
from	IN	from
the	DT	the
crisis	NN	crisis
,	,	,
and	CC	and
building	VBG	build
toward	IN	toward
an	DT	an
open	JJ	open
,	,	,
egalitarian	JJ	egalitarian
,	,	,
and	CC	and
peaceful	JJ	peaceful
world	NN	world
.	SENT	.
Even	RB	even
as	IN	as
we	PP	we
face	VBP	face
personal	JJ	personal
challenges	NNS	challenge
,	,	,
there	EX	there
are	VBP	be
inspiring	JJ	inspiring
acts	NNS	act
of	IN	of
courage	NN	courage
emerging	VBG	emerge
.	SENT	.
Vigilance	NN	vigilance
is	VBZ	be
essential	JJ	essential
,	,	,
because	IN	because
crises	NNS	crisis
like	IN	like
this	DT	this
one	CD	one
have	VBP	have
the	DT	the
power	NN	power
to	TO	to
make	VB	make
the	DT	the
impossible	JJ	impossible
possible	JJ	possible
.	SENT	.
