As	IN	as
a	DT	a
child	NN	child
growing	VBG	grow
up	RP	up
in	IN	in
Cameroon	NP	Cameroon
,	,	,
I	PP	I
have	VBP	have
fond	JJ	fond
memories	NNS	memory
of	IN	of
playing	VBG	play
in	IN	in
the	DT	the
forests	NNS	forest
,	,	,
collecting	VBG	collect
fruits	NNS	fruit
and	CC	and
herbs	NNS	herb
,	,	,
and	CC	and
finding	VBG	find
a	DT	a
deep	JJ	deep
sense	NN	sense
of	IN	of
peace	NN	peace
among	IN	among
the	DT	the
trees	NNS	tree
.	SENT	.
My	PP$	my
birthday	NN	birthday
even	RB	even
falls	VBZ	fall
on	IN	on
the	DT	the
International	NP	International
Day	NP	Day
of	IN	of
Forests	NNS	forest
,	,	,
which	WDT	which
always	RB	always
felt	VBD	feel
like	IN	like
a	DT	a
special	JJ	special
connection	NN	connection
to	TO	to
these	DT	these
vital	JJ	vital
ecosystems	NNS	ecosystem
.	SENT	.
Now	RB	now
,	,	,
as	IN	as
a	DT	a
campaigner	NN	campaigner
with	IN	with
Greenpeace	NP	Greenpeace
Africa	NP	Africa
,	,	,
I	PP	I
'm	VBP	be
dedicated	VBN	dedicate
to	TO	to
fighting	VBG	fight
the	DT	the
destruction	NN	destruction
of	IN	of
forests	NNS	forest
to	TO	to
make	VB	make
way	NN	way
for	IN	for
monoculture	NN	monoculture
plantations	NNS	plantation
.	SENT	.
These	DT	these
plantations	NNS	plantation
release	NN	release
carbon	NN	carbon
into	IN	into
the	DT	the
atmosphere	NN	atmosphere
,	,	,
put	VBD	put
communities	NNS	community
and	CC	and
species	NNS	specie
at	IN	at
risk	NN	risk
,	,	,
and	CC	and
can	MD	can
never	RB	never
truly	RB	truly
replace	VB	replace
the	DT	the
rich	JJ	rich
biodiversity	NN	biodiversity
and	CC	and
medicinal	JJ	medicinal
value	NN	value
of	IN	of
natural	JJ	natural
forests	NNS	forest
.	SENT	.
I	PP	I
see	VBP	see
through	IN	through
the	DT	the
greenwashing	NN	greenwashing
tactics	NNS	tactic
used	VBN	use
by	IN	by
industries	NNS	industry
that	WDT	that
try	VBP	try
to	TO	to
offset	VB	offset
their	PP$	their
emissions	NNS	emission
by	IN	by
planting	VBG	plant
artificial	JJ	artificial
monocultures	NNS	monoculture
.	SENT	.
It	PP	it
's	VBZ	be
crucial	JJ	crucial
that	IN	that
we	PP	we
recognize	VBP	recognize
the	DT	the
rights	NNS	right
of	IN	of
Indigenous	JJ	indigenous
peoples	NNS	people
and	CC	and
ensure	VB	ensure
their	PP$	their
inclusion	NN	inclusion
in	IN	in
policy	NN	policy
decisions	NNS	decision
.	SENT	.
The	DT	the
logging	NN	logging
that	WDT	that
's	VBZ	be
displacing	VBG	displace
people	NNS	people
,	,	,
altering	VBG	alter
the	DT	the
climate	NN	climate
,	,	,
and	CC	and
shattering	VBG	shatter
community	NN	community
harmony	NN	harmony
only	RB	only
benefits	VBZ	benefit
a	DT	a
few	JJ	few
outsiders	NNS	outsider
,	,	,
leaving	VBG	leave
lasting	JJ	lasting
damage	NN	damage
in	IN	in
its	PP$	its
wake	NN	wake
.	SENT	.
