In	IN	in
the	DT	the
vast	JJ	vast
expanse	NN	expanse
of	IN	of
our	PP$	our
oceans	NNS	ocean
,	,	,
a	DT	a
hidden	JJ	hidden
crisis	NN	crisis
unfolds	VBZ	unfold
:	:	:
modern	JJ	modern
slavery	NN	slavery
in	IN	in
the	DT	the
fishing	NN	fishing
industry	NN	industry
,	,	,
disproportionately	RB	disproportionately
impacting	VBG	impact
migrant	JJ	migrant
workers	NNS	worker
from	IN	from
Indonesia	NP	Indonesia
and	CC	and
the	DT	the
Philippines	NPS	Philippine
.	SENT	.
Media	NNS	medium
exposures	NNS	exposure
have	VBP	have
brought	VBN	bring
to	TO	to
light	VB	light
the	DT	the
inhumane	JJ	inhumane
conditions	NNS	condition
these	DT	these
workers	NNS	worker
endure	VBP	endure
,	,	,
trapped	VBN	trap
in	IN	in
cycles	NNS	cycle
of	IN	of
exploitation	NN	exploitation
far	RB	far
from	IN	from
shore	NN	shore
.	SENT	.
A	DT	a
key	JJ	key
factor	NN	factor
enabling	VBG	enable
this	DT	this
abuse	NN	abuse
is	VBZ	be
transshipment	NN	transshipment
,	,	,
the	DT	the
practice	NN	practice
of	IN	of
transferring	VBG	transfer
catch	NN	catch
between	IN	between
vessels	NNS	vessel
at	IN	at
sea	NN	sea
.	SENT	.
This	DT	this
allows	VBZ	allow
crews	NNS	crew
to	TO	to
remain	VB	remain
isolated	VBN	isolate
for	IN	for
months	NNS	month
or	CC	or
even	RB	even
years	NNS	year
,	,	,
creating	VBG	create
an	DT	an
environment	NN	environment
ripe	JJ	ripe
for	IN	for
forced	JJ	forced
labor	NN	labor
and	CC	and
unchecked	JJ	unchecked
exploitation	NN	exploitation
.	SENT	.
Despite	IN	despite
these	DT	these
realities	NNS	reality
,	,	,
governments	NNS	government
have	VBP	have
fallen	VBN	fall
short	RB	short
in	IN	in
their	PP$	their
duty	NN	duty
to	TO	to
protect	VB	protect
these	DT	these
vulnerable	JJ	vulnerable
individuals	NNS	individual
.	SENT	.
Greenpeace	NP	Greenpeace
Southeast	NP	Southeast
Asia	NP	Asia
's	POS	's
report	NN	report
,	,	,
“	``	"
Seabound	JJ	Seabound
:	:	:
The	DT	the
Journey	NP	Journey
to	TO	to
Modern	NP	Modern
Slavery	NN	slavery
on	IN	on
the	DT	the
High	JJ	high
Seas	NNS	sea
,	,	,
”	''	"
sheds	VBZ	shed
light	NN	light
on	IN	on
this	DT	this
through	IN	through
firsthand	JJ	firsthand
testimonials	NNS	testimonial
from	IN	from
fishers	NNS	fisher
.	SENT	.
They	PP	they
recount	VBP	recount
experiences	NNS	experience
with	IN	with
deceptive	JJ	deceptive
recruitment	NN	recruitment
agencies	NNS	agency
that	WDT	that
prey	VBP	prey
on	IN	on
economic	JJ	economic
desperation	NN	desperation
,	,	,
contracts	NNS	contract
riddled	VBD	riddle
with	IN	with
language	NN	language
barriers	NNS	barrier
that	WDT	that
obscure	VBP	obscure
true	JJ	true
terms	NNS	term
,	,	,
and	CC	and
the	DT	the
push	NN	push
into	IN	into
distant	JJ	distant
water	NN	water
fishing	NN	fishing
fleets	NNS	fleet
driven	VBN	drive
by	IN	by
overfishing	VBG	overfish
in	IN	in
closer	JJR	close
waters	NNS	water
.	SENT	.
On	IN	on
Human	NP	Human
Rights	NPS	Rights
Day	NP	Day
,	,	,
we	PP	we
call	VBP	call
on	IN	on
ASEAN	NP	ASEAN
states	NNS	state
to	TO	to
take	VB	take
decisive	JJ	decisive
action	NN	action
:	:	:
enforce	VB	enforce
existing	JJ	existing
laws	NNS	law
,	,	,
tackle	VB	tackle
discrimination	NN	discrimination
against	IN	against
migrant	JJ	migrant
workers	NNS	worker
,	,	,
and	CC	and
foster	JJ	foster
ethical	JJ	ethical
practices	NNS	practice
across	IN	across
the	DT	the
industry	NN	industry
to	TO	to
end	VB	end
this	DT	this
modern-day	JJ	modern-day
slavery	NN	slavery
.	SENT	.
