Six	CD	six
months	NNS	month
ago	RB	ago
,	,	,
I	PP	I
visited	VBD	visit
the	DT	the
Geraizeiros	NP	<unknown>
community	NN	community
in	IN	in
Bahia	NP	Bahia
,	,	,
Brazil	NP	Brazil
,	,	,
along	RB	along
with	IN	with
some	DT	some
journalists	NNS	journalist
.	SENT	.
While	IN	while
we	PP	we
were	VBD	be
there	RB	there
,	,	,
armed	JJ	armed
men	NNS	man
who	WP	who
posed	VBD	pose
as	IN	as
police	NNS	police
arrived	VBN	arrive
and	CC	and
intimidated	VBN	intimidate
us	PP	us
with	IN	with
assault	NN	assault
rifles	NNS	rifle
.	SENT	.
They	PP	they
demanded	VBD	demand
entry	NN	entry
without	IN	without
showing	VBG	show
any	DT	any
warrants	NNS	warrant
or	CC	or
identification	NN	identification
.	SENT	.
After	IN	after
two	CD	two
hours	NNS	hour
,	,	,
they	PP	they
finally	RB	finally
left	VBD	leave
,	,	,
but	CC	but
not	RB	not
before	IN	before
threatening	VBG	threaten
to	TO	to
return	NN	return
,	,	,
which	WDT	which
left	VBD	leave
the	DT	the
entire	JJ	entire
community	NN	community
living	VBG	live
in	IN	in
fear	NN	fear
.	SENT	.
This	DT	this
incident	NN	incident
is	VBZ	be
a	DT	a
stark	JJ	stark
example	NN	example
of	IN	of
the	DT	the
ongoing	JJ	ongoing
violence	NN	violence
tied	VBN	tie
to	TO	to
agribusiness	NN	agribusiness
expansion	NN	expansion
in	IN	in
the	DT	the
region	NN	region
.	SENT	.
Companies	NNS	company
like	IN	like
Agroneg√≥cio	NP	<unknown>
Estrondo	NP	Estrondo
have	VBP	have
deforested	VBN	deforest
huge	JJ	huge
areas	NNS	area
to	TO	to
make	VB	make
way	NN	way
for	IN	for
soya	NN	soya
farming	NN	farming
,	,	,
invading	VBG	invade
the	DT	the
traditional	JJ	traditional
lands	NNS	land
of	IN	of
communities	NNS	community
like	IN	like
the	DT	the
Geraizeiros	NP	<unknown>
.	SENT	.
The	DT	the
soya	NN	soya
produced	VBD	produce
there	EX	there
is	VBZ	be
sold	VBN	sell
to	TO	to
major	JJ	major
traders	NNS	trader
such	JJ	such
as	IN	as
Cargill	NP	Cargill
and	CC	and
Bunge	NP	Bunge
,	,	,
who	WP	who
in	IN	in
turn	NN	turn
supply	NN	supply
fast	JJ	fast
food	NN	food
chains	NNS	chain
.	SENT	.
These	DT	these
events	NNS	event
underscore	VBP	underscore
the	DT	the
deep	JJ	deep
connections	NNS	connection
between	IN	between
human	JJ	human
rights	NNS	right
abuses	NNS	abuse
and	CC	and
environmental	JJ	environmental
destruction	NN	destruction
.	SENT	.
It	PP	it
's	VBZ	be
time	NN	time
to	TO	to
demand	VB	demand
change	NN	change
.	SENT	.
