Greenpeace	NP	Greenpeace
's	POS	's
Pole	NN	Pole
to	TO	to
Pole	NP	Pole
voyage	NN	voyage
took	VBD	take
us	PP	us
on	IN	on
an	DT	an
incredible	JJ	incredible
journey	NN	journey
across	IN	across
the	DT	the
world	NN	world
's	POS	's
oceans	NNS	ocean
,	,	,
where	WRB	where
we	PP	we
documented	VBD	document
breathtaking	JJ	breathtaking
wonders	NNS	wonder
alongside	IN	alongside
urgent	JJ	urgent
threats	NNS	threat
from	IN	from
climate	NN	climate
change	NN	change
,	,	,
overfishing	NN	overfishing
,	,	,
plastic	JJ	plastic
pollution	NN	pollution
,	,	,
and	CC	and
deep-sea	NN	deep-sea
mining	NN	mining
.	SENT	.
Throughout	IN	throughout
this	DT	this
expedition	NN	expedition
,	,	,
we	PP	we
advocated	VBD	advocate
strongly	RB	strongly
for	IN	for
a	DT	a
UN	NP	UN
Global	NP	Global
Ocean	NP	Ocean
Treaty	NP	Treaty
that	WDT	that
would	MD	would
establish	VB	establish
sanctuaries	NNS	sanctuary
to	TO	to
protect	VB	protect
these	DT	these
vital	JJ	vital
ecosystems	NNS	ecosystem
.	SENT	.
Our	PP$	our
travels	NNS	travel
began	VBD	begin
in	IN	in
the	DT	the
Antarctic	NP	Antarctic
,	,	,
where	WRB	where
we	PP	we
witnessed	VBD	witness
the	DT	the
impacts	NNS	impact
on	IN	on
penguin	NN	penguin
populations	NNS	population
,	,	,
with	IN	with
declines	NNS	decline
linked	VBN	link
to	TO	to
scarcity	NN	scarcity
of	IN	of
krill	NN	krill
,	,	,
a	DT	a
key	JJ	key
food	NN	food
source	NN	source
affected	VBN	affect
by	IN	by
environmental	JJ	environmental
pressures	NNS	pressure
.	SENT	.
Moving	VBG	move
to	TO	to
the	DT	the
Amazon	NP	Amazon
Reef	NP	Reef
,	,	,
our	PP$	our
team	NN	team
confirmed	VBD	confirm
the	DT	the
presence	NN	presence
of	IN	of
whale	NN	whale
breeding	NN	breeding
grounds	NNS	ground
,	,	,
highlighting	VBG	highlight
the	DT	the
area	NN	area
's	POS	's
importance	NN	importance
for	IN	for
marine	JJ	marine
life	NN	life
.	SENT	.
In	IN	in
the	DT	the
Sargasso	NP	Sargasso
Sea	NP	Sea
,	,	,
we	PP	we
observed	VBD	observe
wildlife	NN	wildlife
entangled	VBN	entangle
in	IN	in
plastic	JJ	plastic
debris	NN	debris
,	,	,
underscoring	VBG	underscore
the	DT	the
pervasive	JJ	pervasive
pollution	NN	pollution
crisis	NN	crisis
.	SENT	.
Finally	RB	finally
,	,	,
at	IN	at
the	DT	the
Lost	VBN	lose
City	NP	City
hydrothermal	JJ	hydrothermal
vents	NNS	vent
,	,	,
we	PP	we
explored	VBD	explore
unique	JJ	unique
underwater	JJ	underwater
formations	NNS	formation
now	RB	now
at	IN	at
risk	NN	risk
from	IN	from
potential	JJ	potential
deep-sea	NN	deep-sea
mining	NN	mining
activities	NNS	activity
.	SENT	.
As	IN	as
part	NN	part
of	IN	of
our	PP$	our
efforts	NNS	effort
,	,	,
we	PP	we
produced	VBD	produce
the	DT	the
film	NN	film
"	``	"
Turtle	NP	Turtle
Journey	NP	Journey
"	''	"
to	TO	to
raise	VB	raise
awareness	NN	awareness
about	IN	about
ocean	NN	ocean
conservation	NN	conservation
.	SENT	.
We	PP	we
also	RB	also
directly	RB	directly
confronted	VBN	confront
fishing	NN	fishing
vessels	NNS	vessel
operating	VBG	operate
in	IN	in
sensitive	JJ	sensitive
areas	NNS	area
,	,	,
and	CC	and
our	PP$	our
researchers	NNS	researcher
gathered	VBD	gather
data	NNS	datum
on	IN	on
turtles	NNS	turtle
and	CC	and
sharks	NNS	shark
to	TO	to
support	VB	support
protection	NN	protection
initiatives	NNS	initiative
.	SENT	.
Despite	IN	despite
these	DT	these
discoveries	NNS	discovery
and	CC	and
actions	NNS	action
,	,	,
UN	NP	UN
negotiations	NNS	negotiation
on	IN	on
ocean	NN	ocean
protection	NN	protection
have	VBP	have
been	VBN	be
disappointing	JJ	disappointing
so	RB	so
far	RB	far
.	SENT	.
That	DT	that
's	VBZ	be
why	WRB	why
we	PP	we
're	VBP	be
urging	VBG	urge
leaders	NNS	leader
and	CC	and
communities	NNS	community
worldwide	RB	worldwide
to	TO	to
push	VB	push
for	IN	for
stronger	JJR	strong
global	JJ	global
action	NN	action
to	TO	to
safeguard	VB	safeguard
our	PP$	our
oceans	NNS	ocean
for	IN	for
future	JJ	future
generations	NNS	generation
.	SENT	.
