In	IN	in
the	DT	the
face	NN	face
of	IN	of
the	DT	the
escalating	VBG	escalate
climate	NN	climate
crisis	NN	crisis
,	,	,
transforming	VBG	transform
how	WRB	how
we	PP	we
use	VBP	use
land	NN	land
is	VBZ	be
not	RB	not
just	RB	just
an	DT	an
option—it	NN	<unknown>
's	VBZ	be
essential	JJ	essential
for	IN	for
our	PP$	our
survival	NN	survival
.	SENT	.
Industrial	JJ	industrial
agriculture	NN	agriculture
is	VBZ	be
wreaking	VBG	wreak
havoc	NN	havoc
by	IN	by
destroying	VBG	destroy
vast	JJ	vast
forests	NNS	forest
and	CC	and
eroding	VBG	erode
biodiversity	NN	biodiversity
,	,	,
driving	VBG	drive
countless	JJ	countless
species	NNS	specie
perilously	RB	perilously
close	VB	close
to	TO	to
extinction	NN	extinction
.	SENT	.
To	TO	to
turn	VB	turn
this	DT	this
around	RB	around
,	,	,
we	PP	we
must	MD	must
halt	VB	halt
the	DT	the
relentless	JJ	relentless
expansion	NN	expansion
of	IN	of
such	JJ	such
practices	NNS	practice
,	,	,
commit	VB	commit
to	TO	to
restoring	VBG	restore
natural	JJ	natural
areas	NNS	area
,	,	,
and	CC	and
embrace	VB	embrace
ecological	JJ	ecological
farming	NN	farming
methods	NNS	method
that	WDT	that
minimize	VBP	minimize
chemical	JJ	chemical
use	NN	use
and	CC	and
safeguard	VB	safeguard
vital	JJ	vital
insect	NN	insect
populations	NNS	population
.	SENT	.
At	IN	at
the	DT	the
heart	NN	heart
of	IN	of
this	DT	this
effort	NN	effort
is	VBZ	be
the	DT	the
need	NN	need
to	TO	to
respect	VB	respect
the	DT	the
rights	NNS	right
of	IN	of
Indigenous	JJ	indigenous
Peoples	NPS	Peoples
,	,	,
whose	WP$	whose
lands	NNS	land
play	VBP	play
a	DT	a
crucial	JJ	crucial
role	NN	role
in	IN	in
preserving	VBG	preserve
biodiversity	NN	biodiversity
.	SENT	.
Meanwhile	RB	meanwhile
,	,	,
intensive	JJ	intensive
farming	NN	farming
is	VBZ	be
degrading	VBG	degrade
our	PP$	our
soils	NNS	soil
,	,	,
which	WDT	which
serve	VBP	serve
as	IN	as
critical	JJ	critical
stores	NNS	store
of	IN	of
carbon	NN	carbon
.	SENT	.
By	IN	by
shifting	VBG	shift
toward	IN	toward
plant-based	JJ	<unknown>
diets	NNS	diet
and	CC	and
reducing	VBG	reduce
meat	NN	meat
consumption	NN	consumption
,	,	,
we	PP	we
can	MD	can
boost	VB	boost
efficiency	NN	efficiency
,	,	,
feed	VB	feed
more	JJR	more
people	NNS	people
,	,	,
improve	VB	improve
public	JJ	public
health	NN	health
,	,	,
and	CC	and
significantly	RB	significantly
cut	VB	cut
emissions	NNS	emission
from	IN	from
both	DT	both
agriculture	NN	agriculture
and	CC	and
deforestation	NN	deforestation
.	SENT	.
Ultimately	RB	ultimately
,	,	,
protecting	VBG	protect
forests	NNS	forest
and	CC	and
grasslands	NNS	grassland
is	VBZ	be
key	JJ	key
to	TO	to
enhancing	VBG	enhance
carbon	NN	carbon
sequestration	NN	sequestration
and	CC	and
keeping	VBG	keep
global	JJ	global
warming	NN	warming
limited	VBN	limit
to	TO	to
1.5°C	NP	<unknown>
.	SENT	.
These	DT	these
steps	NNS	step
toward	IN	toward
better	JJR	good
land	NN	land
use	NN	use
offer	VBP	offer
a	DT	a
path	NN	path
forward	RB	forward
in	IN	in
combating	VBG	combat
the	DT	the
climate	NN	climate
crisis	NN	crisis
.	SENT	.
