June	NP	June
marked	VBD	mark
the	DT	the
hottest	JJS	hot
month	NN	month
on	IN	on
record	NN	record
,	,	,
and	CC	and
July	NP	July
is	VBZ	be
on	IN	on
track	NN	track
to	TO	to
surpass	VB	surpass
it	PP	it
.	SENT	.
Across	IN	across
Europe	NP	Europe
,	,	,
temperatures	NNS	temperature
soared	VBD	soar
to	TO	to
45.6°C	JJ	<unknown>
in	IN	in
France	NP	France
,	,	,
while	NN	while
in	IN	in
India	NP	India
,	,	,
heat	NN	heat
exceeded	VBD	exceed
50°C	NN	<unknown>
,	,	,
leading	VBG	lead
to	TO	to
deaths	NNS	death
and	CC	and
raising	VBG	raise
concerns	NNS	concern
about	IN	about
potential	JJ	potential
future	JJ	future
uninhabitability	NN	uninhabitability
in	IN	in
affected	JJ	affected
areas	NNS	area
.	SENT	.
European	JJ	European
leaders	NNS	leader
are	VBP	be
delaying	VBG	delay
the	DT	the
transition	NN	transition
away	RB	away
from	IN	from
fossil	JJ	fossil
fuels	NNS	fuel
,	,	,
citing	VBG	cite
economic	JJ	economic
concerns	NNS	concern
.	SENT	.
However	RB	however
,	,	,
achieving	VBG	achieve
net	JJ	net
zero	NN	zero
emissions	NNS	emission
could	MD	could
generate	VB	generate
jobs	NNS	job
,	,	,
deliver	VB	deliver
health	NN	health
benefits	NNS	benefit
,	,	,
and	CC	and
result	NN	result
in	IN	in
trillions	NNS	trillion
in	IN	in
savings	NNS	saving
.	SENT	.
Around	IN	around
the	DT	the
world	NN	world
,	,	,
protests	NNS	protest
are	VBP	be
demanding	VBG	demand
urgent	JJ	urgent
action	NN	action
.	SENT	.
Examples	NNS	example
include	VBP	include
the	DT	the
successful	JJ	successful
efforts	NNS	effort
to	TO	to
save	VB	save
Hambach	NP	Hambach
Forest	NP	Forest
and	CC	and
the	DT	the
Fridays	NNS	Friday
for	IN	for
Future	JJ	future
movement	NN	movement
.	SENT	.
Greenpeace	NP	Greenpeace
's	POS	's
Unite	NN	unite
for	IN	for
Climate	NN	climate
tour	NN	tour
is	VBZ	be
traveling	VBG	travel
across	IN	across
Europe	NP	Europe
to	TO	to
expose	VB	expose
the	DT	the
barriers	NNS	barrier
to	TO	to
change	VB	change
,	,	,
connect	VB	connect
those	DT	those
opposing	JJ	opposing
inaction	NN	inaction
,	,	,
and	CC	and
highlight	VB	highlight
the	DT	the
real	JJ	real
impacts	NNS	impact
of	IN	of
the	DT	the
climate	NN	climate
crisis	NN	crisis
.	SENT	.
Looking	VBG	look
ahead	RB	ahead
,	,	,
by	IN	by
2050	CD	@card@
,	,	,
75	CD	@card@
%	NN	%
of	IN	of
cities	NNS	city
could	MD	could
face	VB	face
dramatically	RB	dramatically
shifted	VBN	shift
climates	NNS	climate
.	SENT	.
Heat	NN	heat
exposure	NN	exposure
is	VBZ	be
increasing	VBG	increase
,	,	,
and	CC	and
coal	NN	coal
remains	VBZ	remain
a	DT	a
major	JJ	major
contributor	NN	contributor
,	,	,
accounting	NN	accounting
for	IN	for
46	CD	@card@
%	NN	%
of	IN	of
global	JJ	global
CO2	NP	<unknown>
emissions	NNS	emission
.	SENT	.
