Millions	NNS	million
of	IN	of
school	NN	school
students	NNS	student
worldwide	RB	worldwide
protested	VBD	protest
not	RB	not
for	IN	for
higher	JJR	high
fees	NNS	fee
or	CC	or
jobs	NNS	job
,	,	,
but	CC	but
out	RB	out
of	IN	of
love	NN	love
for	IN	for
the	DT	the
planet	NN	planet
and	CC	and
concern	NN	concern
over	IN	over
climate	NN	climate
change	NN	change
.	SENT	.
I	PP	I
reflect	VBP	reflect
on	IN	on
my	PP$	my
own	JJ	own
school	NN	school
days	NNS	day
lacking	VBG	lack
such	JJ	such
awareness	NN	awareness
,	,	,
praising	VBG	praise
this	DT	this
unprecedented	JJ	unprecedented
organic	JJ	organic
movement	NN	movement
's	POS	's
global	JJ	global
scale	NN	scale
,	,	,
driven	VBN	drive
by	IN	by
the	DT	the
students	NNS	student
'	POS	'
clear	JJ	clear
vision	NN	vision
,	,	,
honest	JJ	honest
intentions	NNS	intention
,	,	,
and	CC	and
environmental	JJ	environmental
worries	NNS	worry
.	SENT	.
Tech-savvy	NN	Tech-savvy
millennials	NNS	<unknown>
have	VBP	have
revived	VBN	revive
street	NN	street
protests	NNS	protest
with	IN	with
creativity	NN	creativity
,	,	,
crafting	VBG	craft
delightful	JJ	delightful
banners	NNS	banner
and	CC	and
redefining	VBG	redefin
slogan-writing	NN	slogan-writing
,	,	,
becoming	VBG	become
part	NN	part
of	IN	of
history	NN	history
.	SENT	.
The	DT	the
post	NN	post
highlights	VBZ	highlight
a	DT	a
few	JJ	few
top	JJ	top
banner	NN	banner
messages	NNS	message
,	,	,
noting	VBG	note
"	``	"
May	NP	May
the	DT	the
force	NN	force
be	VB	be
with	IN	with
you	PP	you
"	''	"
as	IN	as
a	DT	a
standout	NN	standout
.	SENT	.
