Cyclone	NP	Cyclone
Idai	NP	<unknown>
has	VBZ	have
devastated	VBN	devastate
Mozambique	NP	Mozambique
,	,	,
Malawi	NP	Malawi
,	,	,
and	CC	and
Zimbabwe	NP	Zimbabwe
,	,	,
affecting	VBG	affect
millions	NNS	million
with	IN	with
rising	VBG	rise
deaths	NNS	death
and	CC	and
destruction	NN	destruction
,	,	,
potentially	RB	potentially
the	DT	the
region	NN	region
's	POS	's
worst	JJS	bad
disaster	NN	disaster
per	IN	per
the	DT	the
UN	NP	UN
.	SENT	.
Extreme	JJ	extreme
weather	NN	weather
is	VBZ	be
increasing	VBG	increase
,	,	,
including	VBG	include
Zimbabwe	NP	Zimbabwe
's	POS	's
recent	JJ	recent
drought	NN	drought
,	,	,
2000	NP	@card@
's	POS	's
Cyclone	NP	Cyclone
Eline	NP	Eline
,	,	,
and	CC	and
Lake	NP	Lake
Chilwa	NP	Chilwa
's	POS	's
drying	VBG	dry
due	JJ	due
to	TO	to
climate	NN	climate
change	NN	change
.	SENT	.
Chimanimani	NP	<unknown>
,	,	,
Zimbabwe	NP	Zimbabwe
's	POS	's
hardest-hit	JJ	hardest-hit
area	NN	area
,	,	,
saw	VBD	see
roads	NNS	road
,	,	,
homes	NNS	home
,	,	,
and	CC	and
lives	NNS	life
lost	VBD	lose
.	SENT	.
As	IN	as
someone	NN	someone
in	IN	in
the	DT	the
diaspora	NN	Diaspora
,	,	,
I	PP	I
mobilized	VBD	mobilize
aid	NN	aid
via	IN	via
social	JJ	social
media	NNS	medium
,	,	,
inspiring	JJ	inspiring
community	NN	community
relief	NN	relief
efforts	NNS	effort
.	SENT	.
Climate	NN	climate
change	NN	change
demands	NNS	demand
urgent	JJ	urgent
Paris	NP	Paris
Agreement	NN	agreement
action	NN	action
integrated	VBN	integrate
with	IN	with
development	NN	development
;	:	;
people-powered	JJ	<unknown>
movements	NNS	movement
grow	VBP	grow
,	,	,
demanding	VBG	demand
more	JJR	more
from	IN	from
leaders	NNS	leader
.	SENT	.
Aid	NN	aid
organizations	NNS	organization
include	VBP	include
Save	VB	save
the	DT	the
Children	NP	Children
,	,	,
Médecins	NP	<unknown>
Sans	NP	Sans
Frontières	NP	<unknown>
,	,	,
and	CC	and
Red	NP	Red
Cross	NP	Cross
;	:	;
join	VB	join
for	IN	for
climate	NN	climate
justice	NN	justice
.	SENT	.
