Dumaguete	NP	<unknown>
City	NP	City
in	IN	in
the	DT	the
Philippines	NPS	Philippine
,	,	,
once	RB	once
a	DT	a
beautiful	JJ	beautiful
landscape	NN	landscape
,	,	,
has	VBZ	have
been	VBN	be
turned	VBN	turn
into	IN	into
a	DT	a
dumping	VBG	dump
ground	NN	ground
for	IN	for
global	JJ	global
plastic	JJ	plastic
pollution	NN	pollution
.	SENT	.
I	PP	I
witnessed	VBD	witness
its	PP$	its
impacts	NNS	impact
firsthand	RB	firsthand
during	IN	during
my	PP$	my
visit	NN	visit
.	SENT	.
While	IN	while
Southeast	NP	Southeast
Asia	NP	Asia
is	VBZ	be
often	RB	often
blamed	VBN	blame
for	IN	for
this	DT	this
crisis	NN	crisis
,	,	,
the	DT	the
waste	NN	waste
originates	VBZ	originate
mainly	RB	mainly
from	IN	from
Europe	NP	Europe
and	CC	and
North	NP	North
America	NP	America
.	SENT	.
A	DT	a
GAIA	NP	Gaia
report	NN	report
identifies	VBZ	identify
Nestl√©	NP	<unknown>
and	CC	and
Unilever	NP	Unilever
as	IN	as
top	JJ	top
sources	NNS	source
in	IN	in
Philippine	JJ	Philippine
waste	NN	waste
audits	NN	audits
,	,	,
accusing	VBG	accuse
corporations	NNS	corporation
of	IN	of
using	VBG	use
communities	NNS	community
as	IN	as
dumping	VBG	dump
grounds	NNS	ground
via	IN	via
the	DT	the
global	JJ	global
waste	NN	waste
trade	NN	trade
.	SENT	.
It	PP	it
's	VBZ	be
time	NN	time
for	IN	for
corporations	NNS	corporation
to	TO	to
phase	VB	phase
out	RP	out
single-use	NN	<unknown>
plastics	NNS	plastic
.	SENT	.
Local	JJ	local
heroes	NNS	hero
like	IN	like
Froilan	NP	<unknown>
Grate	NP	Grate
and	CC	and
Merci	NP	Merci
Ferrer	NP	Ferrer
are	VBP	be
leading	VBG	lead
the	DT	the
way	NN	way
in	IN	in
the	DT	the
#BreakFreeFromPlastic	JJ	<unknown>
movement	NN	movement
.	SENT	.
