The	DT	the
European	JJ	European
Parliament	NP	Parliament
elections	NNS	election
are	VBP	be
happening	VBG	happen
from	IN	from
23-26	CD	@card@
May	NP	May
,	,	,
and	CC	and
it	PP	it
's	VBZ	be
crucial	JJ	crucial
to	TO	to
vote	VB	vote
to	TO	to
challenge	VB	challenge
authoritarian	JJ	authoritarian
politicians	NNS	politician
and	CC	and
demand	VB	demand
a	DT	a
fair	JJ	fair
society	NN	society
that	WDT	that
protects	VBZ	protect
rights	NNS	right
and	CC	and
the	DT	the
planet	NN	planet
.	SENT	.
While	IN	while
the	DT	the
EU	NP	EU
has	VBZ	have
its	PP$	its
imperfections	NNS	imperfection
,	,	,
it	PP	it
has	VBZ	have
delivered	VBN	deliver
achievements	NNS	achievement
such	JJ	such
as	IN	as
improved	VBN	improve
air	NN	air
quality	NN	quality
and	CC	and
bans	NNS	ban
on	IN	on
toxic	JJ	toxic
chemicals	NNS	chemical
.	SENT	.
Collective	JJ	collective
action	NN	action
through	IN	through
the	DT	the
EU	NP	EU
is	VBZ	be
essential	JJ	essential
for	IN	for
addressing	VBG	address
cross-border	JJ	cross-border
issues	NNS	issue
like	IN	like
climate	NN	climate
change	NN	change
.	SENT	.
Xenophobic	JJ	xenophobic
parties	NNS	party
are	VBP	be
seeking	VBG	seek
control	NN	control
to	TO	to
restrict	VB	restrict
freedoms	NNS	freedom
and	CC	and
accelerate	VB	accelerate
climate	NN	climate
catastrophe	NN	catastrophe
.	SENT	.
Here	RB	here
are	VBP	be
three	CD	three
key	JJ	key
reasons	NNS	reason
to	TO	to
vote	VB	vote
:	:	:
First	RB	first
,	,	,
the	DT	the
EU	NP	EU
plays	VBZ	play
a	DT	a
vital	JJ	vital
role	NN	role
in	IN	in
averting	VBG	avert
climate	NN	climate
chaos	NN	chaos
within	IN	within
a	DT	a
decade	NN	decade
.	SENT	.
Second	RB	second
,	,	,
it	PP	it
makes	VBZ	make
decisions	NNS	decision
on	IN	on
pollution	NN	pollution
and	CC	and
systems	NNS	system
like	IN	like
farming	NN	farming
.	SENT	.
Third	JJ	third
,	,	,
there	EX	there
are	VBP	be
threats	NNS	threat
to	TO	to
rights	NNS	right
like	IN	like
press	NN	press
freedom	NN	freedom
and	CC	and
protest	NN	protest
in	IN	in
countries	NNS	country
including	VBG	include
Hungary	NP	Hungary
,	,	,
Poland	NP	Poland
,	,	,
and	CC	and
Spain	NP	Spain
.	SENT	.
