Young	JJ	young
climate	NN	climate
activists	NNS	activist
are	VBP	be
stepping	VBG	step
up	RP	up
to	TO	to
challenge	VB	challenge
world	NN	world
leaders	NNS	leader
on	IN	on
their	PP$	their
inaction	NN	inaction
against	IN	against
the	DT	the
climate	NN	climate
crisis	NN	crisis
.	SENT	.
In	IN	in
Australia	NP	Australia
,	,	,
students	NNS	student
have	VBP	have
staged	VBN	stage
school	NN	school
walkouts	NNS	walkout
to	TO	to
protest	VB	protest
government	NN	government
policies	NNS	policy
,	,	,
including	VBG	include
support	NN	support
for	IN	for
coal	NN	coal
.	SENT	.
Jamie	NP	Jamie
Margolin	NP	Margolin
founded	VBD	found
Zero	NP	Zero
Hour	NN	hour
and	CC	and
organized	VBN	organize
the	DT	the
Youth	NP	Youth
Climate	NN	climate
March	NP	March
.	SENT	.
She	PP	she
also	RB	also
sued	VBD	sue
Washington	NP	Washington
state	NN	state
over	IN	over
climate	NN	climate
rights	NNS	right
violations	NNS	violation
.	SENT	.
Greta	NP	Greta
Thunberg	NP	Thunberg
started	VBD	start
school	NN	school
strikes	NNS	strike
in	IN	in
Sweden	NP	Sweden
,	,	,
which	WDT	which
inspired	VBD	inspire
global	JJ	global
movements	NNS	movement
.	SENT	.
She	PP	she
delivered	VBD	deliver
a	DT	a
powerful	JJ	powerful
speech	NN	speech
at	IN	at
COP24	NP	<unknown>
.	SENT	.
Litia	NP	<unknown>
,	,	,
a	DT	a
Pacific	NP	Pacific
Islander	NP	Islander
and	CC	and
survivor	NN	survivor
of	IN	of
Cyclone	NP	Cyclone
Winston	NP	Winston
,	,	,
advocates	NNS	advocate
for	IN	for
ending	VBG	end
fossil	JJ	fossil
fuels	NNS	fuel
through	IN	through
Pacific	NP	Pacific
Island	NP	Island
Represent	VBP	represent
.	SENT	.
Marinel	NP	<unknown>
Ubaldo	NP	Ubaldo
,	,	,
a	DT	a
survivor	NN	survivor
of	IN	of
Typhoon	NN	typhoon
Haiyan	NP	<unknown>
from	IN	from
the	DT	the
Philippines	NPS	Philippine
,	,	,
testifies	VBZ	testify
against	IN	against
major	JJ	major
polluters	NNS	polluter
,	,	,
emphasizing	VBG	emphasize
corporate	JJ	corporate
responsibility	NN	responsibility
.	SENT	.
