2018	NP	@card@
has	VBZ	have
been	VBN	be
declared	VBN	declare
the	DT	the
climate	NN	climate
year	NN	year
,	,	,
marked	VBN	mark
by	IN	by
devastating	JJ	devastating
fires	NNS	fire
,	,	,
soaring	VBG	soar
temperatures	NNS	temperature
,	,	,
powerful	JJ	powerful
hurricanes	NNS	hurricane
,	,	,
and	CC	and
the	DT	the
IPCC	NP	<unknown>
's	POS	's
confirmation	NN	confirmation
that	IN	that
our	PP$	our
changing	VBG	change
world	NN	world
is	VBZ	be
set	VBN	set
to	TO	to
worsen	VB	worsen
in	IN	in
the	DT	the
years	NNS	year
ahead	RB	ahead
.	SENT	.
Amid	IN	amid
these	DT	these
urgent	JJ	urgent
signals	NNS	signal
,	,	,
the	DT	the
Climate	NN	climate
Vulnerable	JJ	vulnerable
Forum	NP	Forum
â€™s	POS	's
Virtual	JJ	virtual
Summit	NP	Summit
,	,	,
hosted	VBD	host
by	IN	by
the	DT	the
Marshall	NP	Marshall
Islands	NP	Islands
,	,	,
is	VBZ	be
highlighting	VBG	highlight
leadership	NN	leadership
from	IN	from
vulnerable	JJ	vulnerable
developing	VBG	develop
countries	NNS	country
.	SENT	.
This	DT	this
includes	VBZ	include
the	DT	the
Marshall	NP	Marshall
Islands	NP	Islands
'	POS	'
ambitious	JJ	ambitious
plan	NN	plan
to	TO	to
achieve	VB	achieve
100	CD	@card@
%	NN	%
renewables	NNS	<unknown>
and	CC	and
net-zero	NN	<unknown>
emissions	NNS	emission
by	IN	by
2050	CD	@card@
.	SENT	.
The	DT	the
CVF	NP	CVF
,	,	,
made	VBD	make
up	RP	up
of	IN	of
frontline	NN	frontline
nations	NNS	nation
,	,	,
played	VBD	play
a	DT	a
key	JJ	key
role	NN	role
in	IN	in
influencing	VBG	influence
the	DT	the
Paris	NP	Paris
Agreement	NP	Agreement
and	CC	and
the	DT	the
critical	JJ	critical
1.5-degree	JJ	<unknown>
goal	NN	goal
.	SENT	.
As	IN	as
an	DT	an
online	JJ	online
event	NN	event
,	,	,
this	DT	this
summit	NN	summit
comes	VBZ	come
just	RB	just
before	IN	before
COP24	NP	<unknown>
,	,	,
calling	VBG	call
on	IN	on
major	JJ	major
polluters	NNS	polluter
and	CC	and
governments	NNS	government
worldwide	RB	worldwide
to	TO	to
take	VB	take
urgent	JJ	urgent
action	NN	action
on	IN	on
climate	NN	climate
change	NN	change
.	SENT	.
