In	IN	in
a	DT	a
recent	JJ	recent
conversation	NN	conversation
with	IN	with
Heather	NP	Heather
Russell	NP	Russell
,	,	,
a	DT	a
vegan	NN	vegan
dietitian	NN	dietitian
from	IN	from
The	DT	the
Vegan	NN	vegan
Society	NP	Society
,	,	,
we	PP	we
explored	VBD	explore
the	DT	the
growing	VBG	grow
popularity	NN	popularity
of	IN	of
vegan	NN	vegan
cafes	NNS	cafe
and	CC	and
the	DT	the
delightful	JJ	delightful
surprises	NNS	surprise
found	VBN	find
in	IN	in
plant-based	JJ	<unknown>
meals	NNS	meal
.	SENT	.
Russell	NP	Russell
highlighted	VBD	highlight
the	DT	the
importance	NN	importance
of	IN	of
essential	JJ	essential
supplements	NNS	supplement
for	IN	for
vegans	NNS	vegan
,	,	,
including	VBG	include
vitamin	NN	vitamin
B12	NP	B@card@
,	,	,
D	NP	D
,	,	,
iodine	NN	iodine
,	,	,
and	CC	and
selenium	NN	selenium
,	,	,
to	TO	to
support	VB	support
overall	JJ	overall
health	NN	health
.	SENT	.
She	PP	she
stressed	VBD	stress
the	DT	the
need	NN	need
for	IN	for
balanced	JJ	balanced
nutrition	NN	nutrition
,	,	,
warning	VBG	warn
against	IN	against
relying	VBG	rely
on	IN	on
high-fat	JJ	high-fat
,	,	,
sugary	JJ	sugary
vegan	NN	vegan
junk	NN	junk
food	NN	food
and	CC	and
instead	RB	instead
encouraging	VBG	encourage
a	DT	a
focus	NN	focus
on	IN	on
whole	JJ	whole
grains	NNS	grain
,	,	,
nuts	NNS	nut
,	,	,
fruits	NNS	fruit
,	,	,
vegetables	NNS	vegetable
,	,	,
and	CC	and
legumes	NNS	legume
.	SENT	.
Russell	NP	Russell
also	RB	also
addressed	VBD	address
how	WRB	how
veganism	NN	<unknown>
can	MD	can
be	VB	be
affordable	JJ	affordable
and	CC	and
adaptable	JJ	adaptable
to	TO	to
various	JJ	various
cultures	NNS	culture
,	,	,
making	VBG	make
it	PP	it
accessible	JJ	accessible
for	IN	for
more	JJR	more
people	NNS	people
.	SENT	.
When	WRB	when
it	PP	it
comes	VBZ	come
to	TO	to
innovations	NNS	innovation
like	IN	like
lab-grown	JJ	lab-grown
meat	NN	meat
,	,	,
she	PP	she
critiqued	VBD	<unknown>
options	NNS	option
that	WDT	that
still	RB	still
involve	VBP	involve
animal	JJ	animal
products	NNS	product
.	SENT	.
To	TO	to
promote	VB	promote
sustainability	NN	sustainability
,	,	,
Russell	NP	Russell
recommended	VBD	recommend
choosing	VBG	choose
seasonal	JJ	seasonal
produce	NN	produce
.	SENT	.
Looking	VBG	look
ahead	RB	ahead
,	,	,
she	PP	she
predicts	VBZ	predict
a	DT	a
broader	JJR	broad
shift	NN	shift
toward	IN	toward
plant-based	JJ	<unknown>
diets	NNS	diet
,	,	,
driven	VBN	drive
by	IN	by
their	PP$	their
environmental	JJ	environmental
and	CC	and
health	NN	health
benefits	NNS	benefit
.	SENT	.
For	IN	for
practical	JJ	practical
tips	NNS	tip
,	,	,
Russell	NP	Russell
suggests	VBZ	suggest
incorporating	JJ	incorporating
legumes	NNS	legume
into	IN	into
meals	NNS	meal
and	CC	and
experimenting	VBG	experiment
with	IN	with
plant	NN	plant
milks	NNS	milk
to	TO	to
enhance	VB	enhance
everyday	JJ	everyday
eating	NN	eating
.	SENT	.
