Across	IN	across
the	DT	the
globe	NN	globe
,	,	,
diverse	JJ	diverse
communities	NNS	community
are	VBP	be
turning	VBG	turn
to	TO	to
the	DT	the
courts	NNS	court
to	TO	to
demand	VB	demand
climate	NN	climate
justice	NN	justice
.	SENT	.
Lavender	JJ	lavender
farmers	NNS	farmer
in	IN	in
France	NP	France
,	,	,
beekeepers	NNS	beekeeper
in	IN	in
Portugal	NP	Portugal
,	,	,
Romanian	JJ	Romanian
shepherds	NNS	shepherd
,	,	,
Kenyan	JJ	Kenyan
school	NN	school
children	NNS	child
,	,	,
Swedish	JJ	Swedish
SÃ¡mi	NP	<unknown>
youth	NN	youth
,	,	,
and	CC	and
islanders	NNS	islander
in	IN	in
Germany	NP	Germany
and	CC	and
Fiji	NP	Fiji
are	VBP	be
among	IN	among
those	DT	those
pursuing	VBG	pursue
legal	JJ	legal
actions	NNS	action
to	TO	to
address	VB	address
the	DT	the
climate	NN	climate
crisis	NN	crisis
.	SENT	.
In	IN	in
Switzerland	NP	Switzerland
,	,	,
the	DT	the
group	NN	group
Senior	JJ	Senior
Women	NNS	woman
for	IN	for
Climate	NN	climate
Protection	NP	Protection
is	VBZ	be
suing	VBG	sue
the	DT	the
government	NN	government
,	,	,
calling	VBG	call
for	IN	for
stronger	JJR	strong
reductions	NNS	reduction
in	IN	in
greenhouse	NN	greenhouse
gas	NN	gas
emissions	NNS	emission
to	TO	to
safeguard	VB	safeguard
vulnerable	JJ	vulnerable
elderly	JJ	elderly
people	NNS	people
from	IN	from
the	DT	the
impacts	NNS	impact
of	IN	of
extreme	JJ	extreme
heat	NN	heat
.	SENT	.
A	DT	a
court	NN	court
decision	NN	decision
on	IN	on
this	DT	this
case	NN	case
is	VBZ	be
pending	VBG	pend
.	SENT	.
Meanwhile	RB	meanwhile
,	,	,
in	IN	in
Norway	NP	Norway
,	,	,
Greenpeace	NP	Greenpeace
Nordic	NN	Nordic
and	CC	and
Nature	NP	Nature
and	CC	and
Youth	NP	Youth
are	VBP	be
appealing	VBG	appeal
against	IN	against
the	DT	the
granting	VBG	grant
of	IN	of
Arctic	NP	Arctic
oil	NN	oil
licenses	NNS	license
,	,	,
highlighting	VBG	highlight
the	DT	the
importance	NN	importance
of	IN	of
rights	NNS	right
to	TO	to
a	DT	a
healthy	JJ	healthy
environment	NN	environment
.	SENT	.
Families	NNS	family
from	IN	from
various	JJ	various
countries	NNS	country
have	VBP	have
also	RB	also
taken	VBN	take
legal	JJ	legal
action	NN	action
against	IN	against
the	DT	the
European	NP	European
Union	NP	Union
,	,	,
arguing	VBG	argue
that	IN	that
its	PP$	its
weak	JJ	weak
emission	NN	emission
targets	NNS	target
infringe	VBP	infringe
on	IN	on
fundamental	JJ	fundamental
rights	NNS	right
to	TO	to
life	NN	life
,	,	,
health	NN	health
,	,	,
occupation	NN	occupation
,	,	,
and	CC	and
property	NN	property
.	SENT	.
In	IN	in
the	DT	the
Netherlands	NPS	Netherlands
,	,	,
the	DT	the
landmark	JJ	landmark
Urgenda	NP	<unknown>
case	NN	case
has	VBZ	have
already	RB	already
mandated	VBN	mandate
ambitious	JJ	ambitious
climate	NN	climate
action	NN	action
from	IN	from
the	DT	the
government	NN	government
,	,	,
with	IN	with
an	DT	an
appeal	NN	appeal
set	VBN	set
to	TO	to
be	VB	be
heard	VBN	hear
soon	RB	soon
.	SENT	.
