Indigenous	JJ	indigenous
leaders	NNS	leader
and	CC	and
supporters	NNS	supporter
are	VBP	be
standing	VBG	stand
strong	JJ	strong
against	IN	against
Kinder	NP	Kinder
Morgan	NP	Morgan
's	POS	's
tar	NN	tar
sands	NNS	sand
pipeline	NN	pipeline
in	IN	in
Canada	NP	Canada
.	SENT	.
They	PP	they
're	VBP	be
resisting	VBG	resist
by	IN	by
building	VBG	build
a	DT	a
"	``	"
Watch	NN	watch
House	NN	house
"	''	"
near	IN	near
the	DT	the
pipeline	NN	pipeline
route	NN	route
and	CC	and
organizing	VBG	organize
protests	NNS	protest
,	,	,
where	WRB	where
over	RB	over
10,000	CD	@card@
people	NNS	people
have	VBP	have
marched	VBN	march
and	CC	and
170	CD	@card@
have	VBP	have
been	VBN	be
arrested	VBN	arrest
.	SENT	.
The	DT	the
pipeline	NN	pipeline
lacks	VBZ	lack
Indigenous	JJ	indigenous
consent	NN	consent
and	CC	and
would	MD	would
transport	VB	transport
polluting	VBG	pollute
bitumen	NN	bitumen
.	SENT	.
It	PP	it
would	MD	would
also	RB	also
increase	VB	increase
supertanker	NN	supertanker
traffic	NN	traffic
,	,	,
threatening	VBG	threaten
endangered	JJ	endangered
orcas	NNS	<unknown>
,	,	,
and	CC	and
pose	VB	pose
risks	NNS	risk
of	IN	of
spills	NNS	spill
that	WDT	that
could	MD	could
contaminate	VB	contaminate
water	NN	water
.	SENT	.
Protesters	NNS	protester
are	VBP	be
drawing	VBG	draw
parallels	NNS	parallel
to	TO	to
Standing	NP	Standing
Rock	NP	Rock
,	,	,
where	WRB	where
violence	NN	violence
occurred	VBD	occur
and	CC	and
ETP	NP	<unknown>
filed	VBD	file
a	DT	a
$900	JJ	<unknown>
million	CD	million
SLAPP	NP	<unknown>
suit	NN	suit
against	IN	against
Greenpeace	NP	Greenpeace
and	CC	and
others	NNS	other
to	TO	to
suppress	VB	suppress
dissent	NN	dissent
.	SENT	.
Despite	IN	despite
this	DT	this
,	,	,
the	DT	the
suit	NN	suit
has	VBZ	have
strengthened	VBN	strengthen
the	DT	the
movement	NN	movement
.	SENT	.
Greenpeace	NP	Greenpeace
reaffirms	VBZ	reaffirm
its	PP$	its
commitment	NN	commitment
to	TO	to
protecting	VBG	protect
the	DT	the
coast	NN	coast
.	SENT	.
