Greenpeace	NP	Greenpeace
International	NP	International
's	POS	's
Executive	NP	Executive
Directors	NPS	Directors
,	,	,
Jennifer	NP	Jennifer
Morgan	NP	Morgan
and	CC	and
Bunny	NP	Bunny
McDiarmid	NP	Mcdiarmid
,	,	,
have	VBP	have
shared	VBN	share
their	PP$	their
inspiration	NN	inspiration
from	IN	from
the	DT	the
#MeToo	NN	<unknown>
movement	NN	movement
,	,	,
underscoring	VBG	underscore
the	DT	the
importance	NN	importance
of	IN	of
building	VBG	build
robust	JJ	robust
systems	NNS	system
and	CC	and
fostering	VBG	foster
an	DT	an
inclusive	JJ	inclusive
culture	NN	culture
to	TO	to
create	VB	create
safe	JJ	safe
workplaces	NNS	workplace
for	IN	for
everyone	NN	everyone
.	SENT	.
They	PP	they
point	VBP	point
to	TO	to
the	DT	the
adoption	NN	adoption
of	IN	of
a	DT	a
global	JJ	global
Integrity	NN	integrity
Package	NN	package
,	,	,
which	WDT	which
includes	VBZ	include
a	DT	a
Code	NP	Code
of	IN	of
Conduct	NP	Conduct
and	CC	and
complaint	NN	complaint
protocols	NNS	protocol
.	SENT	.
Offices	NNS	office
are	VBP	be
actively	RB	actively
upgrading	VBG	upgrade
their	PP$	their
processes	NNS	process
and	CC	and
are	VBP	be
set	VBN	set
to	TO	to
implement	VB	implement
annual	JJ	annual
reporting	NN	reporting
on	IN	on
complaints	NNS	complaint
.	SENT	.
The	DT	the
focus	NN	focus
is	VBZ	be
on	IN	on
cultivating	VBG	cultivate
a	DT	a
culture	NN	culture
that	WDT	that
promotes	VBZ	promote
equity	NN	equity
,	,	,
empowerment	NN	empowerment
,	,	,
training	NN	training
,	,	,
and	CC	and
diversity	NN	diversity
,	,	,
ensuring	VBG	ensure
access	NN	access
to	TO	to
trusted	VBN	trust
officers	NNS	officer
for	IN	for
support	NN	support
.	SENT	.
This	DT	this
effort	NN	effort
is	VBZ	be
at	IN	at
the	DT	the
heart	NN	heart
of	IN	of
Greenpeace	NP	Greenpeace
's	POS	's
mission	NN	mission
,	,	,
connecting	VBG	connect
how	WRB	how
we	PP	we
treat	VBP	treat
each	DT	each
other	JJ	other
with	IN	with
our	PP$	our
work	NN	work
to	TO	to
protect	VB	protect
the	DT	the
planet	NN	planet
,	,	,
while	IN	while
recognizing	VBG	recognize
that	IN	that
improvements	NNS	improvement
are	VBP	be
an	DT	an
ongoing	JJ	ongoing
process	NN	process
.	SENT	.
