James	NP	James
(	(	(
Jon	NP	Jon
)	)	)
Castle	NP	Castle
(	(	(
1950-2018	CD	@card@
)	)	)
was	VBD	be
a	DT	a
legendary	JJ	legendary
Greenpeace	NP	Greenpeace
captain	NN	captain
known	VBN	know
for	IN	for
his	PP$	his
maritime	JJ	maritime
skills	NNS	skill
,	,	,
courage	NN	courage
,	,	,
and	CC	and
integrity	NN	integrity
,	,	,
guided	VBN	guide
by	IN	by
principles	NNS	principle
of	IN	of
right	JJ	right
and	CC	and
wrong	JJ	wrong
.	SENT	.
He	PP	he
skippered	VBD	skipper
ships	NNS	ship
in	IN	in
campaigns	NNS	campaign
against	IN	against
whaling	NN	whaling
,	,	,
French	JJ	French
nuclear	JJ	nuclear
testing	NN	testing
in	IN	in
the	DT	the
Pacific	NP	Pacific
,	,	,
and	CC	and
Shell	NP	Shell
's	POS	's
Brent	NP	Brent
Spar	NP	Spar
oil	NN	oil
tank	NN	tank
disposal	NN	disposal
in	IN	in
1995	CD	@card@
,	,	,
leading	VBG	lead
occupations	NNS	occupation
that	WDT	that
sparked	VBD	spark
global	JJ	global
protests	NNS	protest
and	CC	and
policy	NN	policy
changes	NNS	change
,	,	,
including	VBG	include
a	DT	a
North	NP	North
Sea	NP	Sea
dumping	VBG	dump
ban	NN	ban
.	SENT	.
Castle	NP	Castle
advocated	VBD	advocate
moral	JJ	moral
courage	NN	courage
,	,	,
self-reflection	NN	self-reflection
,	,	,
and	CC	and
resistance	NN	resistance
to	TO	to
corporatism	NN	corporatism
in	IN	in
activism	NN	activism
.	SENT	.
He	PP	he
participated	VBD	participate
in	IN	in
protests	NNS	protest
like	IN	like
the	DT	the
Diego	NP	Diego
Garcia	NP	Garcia
invasion	NN	invasion
and	CC	and
later	RBR	later
helped	VBD	help
run	VB	run
a	DT	a
soup	NN	soup
kitchen	NN	kitchen
.	SENT	.
Colleagues	NNS	colleague
remember	VBP	remember
him	PP	him
as	IN	as
compassionate	JJ	compassionate
and	CC	and
inspiring	JJ	inspiring
.	SENT	.
