In	IN	in
a	DT	a
world	NN	world
driven	VBN	drive
by	IN	by
hyperconsumption	NN	hyperconsumption
,	,	,
MAKE	VBP	make
SMTHNG	NP	<unknown>
Week	NP	Week
is	VBZ	be
calling	VBG	call
for	IN	for
action	NN	action
to	TO	to
challenge	VB	challenge
the	DT	the
excessive	JJ	excessive
buying	NN	buying
habits	NNS	habit
that	WDT	that
harm	VBP	harm
our	PP$	our
planet	NN	planet
.	SENT	.
This	DT	this
initiative	NN	initiative
shines	VBZ	shine
a	DT	a
light	NN	light
on	IN	on
how	WRB	how
overbuying	NN	overbuying
in	IN	in
areas	NNS	area
like	IN	like
food	NN	food
,	,	,
fashion	NN	fashion
,	,	,
and	CC	and
technology	NN	technology
fuels	NNS	fuel
climate	NN	climate
change	NN	change
,	,	,
destroys	VBZ	destroy
forests	NNS	forest
,	,	,
and	CC	and
pollutes	VBZ	pollute
oceans	NNS	ocean
.	SENT	.
One	CD	one
major	JJ	major
issue	NN	issue
it	PP	it
addresses	VBZ	address
is	VBZ	be
the	DT	the
waste	NN	waste
generated	VBN	generate
by	IN	by
planned	JJ	planned
obsolescence	NN	obsolescence
,	,	,
where	WRB	where
products	NNS	product
are	VBP	be
designed	VBN	design
to	TO	to
break	VB	break
down	RP	down
quickly	RB	quickly
.	SENT	.
For	IN	for
instance	NN	instance
,	,	,
we	PP	we
now	RB	now
buy	VBP	buy
twice	RB	twice
as	IN	as
many	JJ	many
clothes	NNS	clothes
as	IN	as
before	RB	before
and	CC	and
wear	VB	wear
them	PP	them
for	IN	for
only	JJ	only
half	NN	half
as	IN	as
long	JJ	long
,	,	,
and	CC	and
repairing	VBG	repair
items	NNS	item
often	RB	often
costs	VBZ	cost
more	RBR	more
than	IN	than
simply	RB	simply
replacing	VBG	replace
them	PP	them
.	SENT	.
Instead	RB	instead
,	,	,
MAKE	VBP	make
SMTHNG	NP	<unknown>
Week	NP	Week
encourages	VBZ	encourage
a	DT	a
shift	NN	shift
toward	IN	toward
a	DT	a
culture	NN	culture
that	WDT	that
truly	RB	truly
values	VBZ	value
resources	NNS	resource
.	SENT	.
This	DT	this
means	VBZ	mean
embracing	VBG	embrace
practices	NNS	practice
like	IN	like
repairing	VBG	repair
and	CC	and
upcycling	VBG	upcycle
items	NNS	item
,	,	,
choosing	VBG	choose
vegan	NN	vegan
alternatives	NNS	alternative
,	,	,
and	CC	and
steering	VBG	steer
clear	JJ	clear
of	IN	of
single-use	NN	<unknown>
plastics	NNS	plastic
.	SENT	.
From	IN	from
November	NP	November
23	CD	@card@
to	TO	to
December	NP	December
2	CD	@card@
,	,	,
2018	CD	@card@
,	,	,
people	NNS	people
around	IN	around
the	DT	the
world	NN	world
can	MD	can
join	VB	join
in	IN	in
through	IN	through
global	JJ	global
events	NNS	event
that	WDT	that
bring	VBP	bring
together	RB	together
DIY	NN	DIY
enthusiasts	NNS	enthusiast
,	,	,
Greenpeace	NP	Greenpeace
,	,	,
and	CC	and
our	PP$	our
partners	NNS	partner
for	IN	for
collaborative	JJ	collaborative
activities	NNS	activity
.	SENT	.
To	TO	to
get	VB	get
involved	VBN	involve
,	,	,
check	VB	check
out	RP	out
the	DT	the
guidelines	NNS	guideline
,	,	,
events	NNS	event
calendar	NN	calendar
,	,	,
and	CC	and
branding	VBG	brand
toolkit	NN	<unknown>
.	SENT	.
Follow	VB	follow
along	IN	along
on	IN	on
Instagram	NN	<unknown>
at	IN	at
@makesmthng	NN	<unknown>
and	CC	and
use	VB	use
the	DT	the
hashtag	NN	<unknown>
#makesmthng	NN	<unknown>
to	TO	to
share	VB	share
your	PP$	your
efforts	NNS	effort
.	SENT	.
