Today	NN	today
marks	VBZ	mark
a	DT	a
major	JJ	major
victory	NN	victory
for	IN	for
nature	NN	nature
as	IN	as
the	DT	the
EU-wide	JJ	<unknown>
ban	NN	ban
on	IN	on
the	DT	the
pesticide	NN	pesticide
fipronil	NN	<unknown>
in	IN	in
agriculture	NN	agriculture
takes	VBZ	take
effect	NN	effect
,	,	,
offering	VBG	offer
vital	JJ	vital
protection	NN	protection
to	TO	to
bees	NNS	bee
,	,	,
bumblebees	NNS	bumblebee
,	,	,
butterflies	NNS	butterfly
,	,	,
and	CC	and
other	JJ	other
insects	NNS	insect
.	SENT	.
This	DT	this
ban	NN	ban
addresses	VBZ	address
the	DT	the
dangers	NNS	danger
of	IN	of
fipronil	NP	<unknown>
,	,	,
which	WDT	which
was	VBD	be
at	IN	at
the	DT	the
center	NN	center
of	IN	of
a	DT	a
2017	CD	@card@
egg	NN	egg
contamination	NN	contamination
scandal	NN	scandal
that	WDT	that
impacted	VBD	impact
49	CD	@card@
countries	NNS	country
and	CC	and
revealed	VBD	reveal
deep	JJ	deep
flaws	NNS	flaw
in	IN	in
our	PP$	our
food	NN	food
system	NN	system
.	SENT	.
The	DT	the
pesticide	NN	pesticide
's	POS	's
toxicity	NN	toxicity
to	TO	to
pollinators	NNS	pollinator
,	,	,
particularly	RB	particularly
through	IN	through
its	PP$	its
use	NN	use
in	IN	in
seed	NN	seed
treatments	NNS	treatment
,	,	,
has	VBZ	have
long	RB	long
been	VBN	be
a	DT	a
concern	NN	concern
.	SENT	.
Greenpeace	NP	Greenpeace
has	VBZ	have
been	VBN	be
campaigning	VBG	campaign
for	IN	for
restrictions	NNS	restriction
on	IN	on
fipronil	NP	<unknown>
since	IN	since
2013	CD	@card@
,	,	,
leading	VBG	lead
to	TO	to
those	DT	those
initial	JJ	initial
limits	NNS	limit
and	CC	and
now	RB	now
this	DT	this
full	JJ	full
prohibition	NN	prohibition
across	IN	across
the	DT	the
EU	NP	EU
.	SENT	.
However	RB	however
,	,	,
threats	NNS	threat
to	TO	to
pollinators	NNS	pollinator
persist	VBP	persist
from	IN	from
other	JJ	other
pesticides	NNS	pesticide
like	IN	like
neonicotinoids	NNS	<unknown>
,	,	,
and	CC	and
we	PP	we
urge	VBP	urge
further	JJR	further
bans	NNS	ban
grounded	VBN	ground
in	IN	in
scientific	JJ	scientific
evidence	NN	evidence
.	SENT	.
To	TO	to
truly	RB	truly
protect	VB	protect
our	PP$	our
environment	NN	environment
,	,	,
we	PP	we
must	MD	must
transition	NN	transition
from	IN	from
industrial	JJ	industrial
farming	NN	farming
to	TO	to
ecological	JJ	ecological
farming	NN	farming
practices	NNS	practice
that	WDT	that
address	VBP	address
climate	NN	climate
change	NN	change
,	,	,
biodiversity	NN	biodiversity
loss	NN	loss
,	,	,
and	CC	and
pollution	NN	pollution
.	SENT	.
The	DT	the
upcoming	JJ	upcoming
reform	NN	reform
of	IN	of
the	DT	the
EU	NP	EU
's	POS	's
Common	NP	Common
Agricultural	NP	Agricultural
Policy	NP	Policy
presents	VBZ	present
a	DT	a
key	JJ	key
opportunity	NN	opportunity
to	TO	to
drive	VB	drive
this	DT	this
change	NN	change
.	SENT	.
Here	RB	here
are	VBP	be
12	CD	@card@
actions	NNS	action
to	TO	to
spark	VB	spark
an	DT	an
eco-food	NN	<unknown>
revolution	NN	revolution
.	SENT	.
