The	DT	the
Copenhagen	NP	Copenhagen
Fashion	NP	Fashion
Summit	NP	Summit
brings	VBZ	bring
together	RB	together
major	JJ	major
brands	NNS	brand
such	JJ	such
as	IN	as
H&M	NP	H&M
,	,	,
Zara	NP	Zara
,	,	,
and	CC	and
Burberry	NN	Burberry
to	TO	to
address	VB	address
sustainability	NN	sustainability
in	IN	in
the	DT	the
fashion	NN	fashion
industry	NN	industry
,	,	,
with	IN	with
a	DT	a
key	JJ	key
focus	NN	focus
on	IN	on
circularity	NN	circularity
.	SENT	.
This	DT	this
comes	VBZ	come
amid	IN	amid
an	DT	an
industry	NN	industry
generating	VBG	generate
â‚¬1.5	NP	<unknown>
trillion	CD	trillion
in	IN	in
revenue	NN	revenue
,	,	,
producing	VBG	produce
over	IN	over
a	DT	a
billion	NN	billion
garments	VBZ	garment
annually	RB	annually
,	,	,
and	CC	and
facing	VBG	face
a	DT	a
projected	VBN	project
63	CD	@card@
%	NN	%
growth	NN	growth
in	IN	in
production	NN	production
by	IN	by
2030	CD	@card@
.	SENT	.
The	DT	the
environmental	JJ	environmental
toll	NN	toll
is	VBZ	be
staggering	JJ	staggering
,	,	,
including	VBG	include
the	DT	the
use	NN	use
of	IN	of
80	CD	@card@
billion	NNS	billion
cubic	JJ	cubic
meters	NNS	meter
of	IN	of
water	NN	water
,	,	,
emissions	NNS	emission
exceeding	VBG	exceed
a	DT	a
million	CD	million
tonnes	NNS	tonne
of	IN	of
CO2	NP	<unknown>
,	,	,
and	CC	and
the	DT	the
generation	NN	generation
of	IN	of
92	CD	@card@
million	CD	million
tonnes	NNS	tonne
of	IN	of
waste	NN	waste
each	DT	each
year	NN	year
.	SENT	.
Yet	RB	yet
,	,	,
circularity	NN	circularity
alone	RB	alone
falls	VBZ	fall
short	JJ	short
without	IN	without
addressing	VBG	address
the	DT	the
need	NN	need
to	TO	to
reduce	VB	reduce
overall	JJ	overall
production	NN	production
volumes	NNS	volume
,	,	,
given	VBN	give
that	IN	that
unlimited	JJ	unlimited
growth	NN	growth
cannot	MD	can
continue	VB	continue
on	IN	on
a	DT	a
finite	JJ	finite
planet	NN	planet
.	SENT	.
Brands	NNS	brand
need	VBP	need
to	TO	to
move	VB	move
away	RB	away
from	IN	from
fast	JJ	fast
fashion	NN	fashion
models	NNS	model
,	,	,
instead	RB	instead
promoting	VBG	promote
clothes	NNS	clothes
that	WDT	that
are	VBP	be
durable	JJ	durable
and	CC	and
repairable	JJ	repairable
,	,	,
while	IN	while
encouraging	VBG	encourage
consumers	NNS	consumer
to	TO	to
buy	VB	buy
less	RBR	less
.	SENT	.
This	DT	this
shift	NN	shift
is	VBZ	be
essential	JJ	essential
,	,	,
rather	RB	rather
than	IN	than
depending	VBG	depend
solely	RB	solely
on	IN	on
consumer	NN	consumer
recycling	NN	recycling
or	CC	or
other	JJ	other
superficial	JJ	superficial
solutions	NNS	solution
that	WDT	that
do	VBP	do
n't	RB	n't
tackle	VB	tackle
the	DT	the
root	NN	root
issues	NNS	issue
.	SENT	.
