Aboard	IN	aboard
the	DT	the
Greenpeace	NP	Greenpeace
ship	NN	ship
Esperanza	NP	Esperanza
,	,	,
I	PP	I
've	VBP	have
been	VBN	be
sailing	VBG	sail
through	IN	through
the	DT	the
nutrient-rich	JJ	nutrient-rich
Atlantic	JJ	Atlantic
waters	NNS	water
off	IN	off
West	NP	West
Africa	NP	Africa
.	SENT	.
Along	IN	along
the	DT	the
way	NN	way
,	,	,
we	PP	we
've	VBP	have
encountered	VBN	encounter
incredible	JJ	incredible
wildlife	NN	wildlife
:	:	:
whales	NNS	whale
,	,	,
dolphins	NNS	dolphin
,	,	,
pelicans	NNS	pelican
,	,	,
flying	VBG	fly
fish	NN	fish
,	,	,
gannets	NNS	gannet
,	,	,
and	CC	and
even	RB	even
bioluminescent	JJ	bioluminescent
plankton	NN	plankton
lighting	VBG	light
up	RP	up
the	DT	the
night	NN	night
.	SENT	.
Our	PP$	our
mission	NN	mission
involves	VBZ	involve
chasing	VBG	chase
illegal	JJ	illegal
fishing	NN	fishing
vessels	NNS	vessel
and	CC	and
witnessing	VBG	witness
the	DT	the
devastation	NN	devastation
caused	VBN	cause
by	IN	by
overfishing	NN	overfishing
.	SENT	.
Yet	RB	yet
,	,	,
in	IN	in
the	DT	the
midst	NN	midst
of	IN	of
this	DT	this
,	,	,
I	PP	I
find	VBP	find
hope	NN	hope
in	IN	in
the	DT	the
beauty	NN	beauty
of	IN	of
nature	NN	nature
around	IN	around
us	PP	us
.	SENT	.
We	PP	we
've	VBP	have
seen	VBN	see
coral	JJ	coral
reefs	NNS	reef
teeming	VBG	teem
with	IN	with
moray	NN	moray
eels	NNS	eel
and	CC	and
lobsters	NNS	lobster
,	,	,
ecosystems	NNS	ecosystem
nourished	VBN	nourish
by	IN	by
upwellings	NNS	<unknown>
,	,	,
mangroves	NNS	mangrove
that	WDT	that
serve	VBP	serve
as	IN	as
vital	JJ	vital
carbon	NN	carbon
sinks	NNS	sink
,	,	,
and	CC	and
beaches	NNS	beach
that	WDT	that
are	VBP	be
crucial	JJ	crucial
for	IN	for
endangered	JJ	endangered
green	JJ	green
sea	NN	sea
turtles	NNS	turtle
.	SENT	.
On	IN	on
remote	JJ	remote
islands	NNS	island
,	,	,
we	PP	we
've	VBP	have
come	VBN	come
across	IN	across
marine	JJ	marine
hippos	NNS	hippo
and	CC	and
manatees	NNS	manatee
,	,	,
along	RB	along
with	IN	with
communities	NNS	community
that	WDT	that
live	VBP	live
in	IN	in
symbiosis	NN	symbiosis
with	IN	with
nature	NN	nature
.	SENT	.
These	DT	these
places	NNS	place
are	VBP	be
vibrant	JJ	vibrant
,	,	,
filled	VBN	fill
with	IN	with
colorful	JJ	colorful
attire	NN	attire
,	,	,
pirogues	NNS	pirogue
gliding	VBG	glide
on	IN	on
the	DT	the
water	NN	water
,	,	,
and	CC	and
the	DT	the
sounds	NNS	sound
of	IN	of
music	NN	music
.	SENT	.
To	TO	to
protect	VB	protect
these	DT	these
wonders	NNS	wonder
,	,	,
I	PP	I
urge	VBP	urge
you	PP	you
to	TO	to
sign	VB	sign
our	PP$	our
petition	NN	petition
for	IN	for
sustainable	JJ	sustainable
fisheries	NNS	fishery
management	NN	management
.	SENT	.
