In	IN	in
Brazil	NP	Brazil
,	,	,
a	DT	a
major	JJ	major
scandal	NN	scandal
has	VBZ	have
exposed	VBN	expose
deep	JJ	deep
flaws	NNS	flaw
in	IN	in
the	DT	the
meat	NN	meat
industry	NN	industry
.	SENT	.
Police	NN	police
investigations	NNS	investigation
revealed	VBD	reveal
that	IN	that
big	JJ	big
companies	NNS	company
like	IN	like
JBS	NP	JBS
and	CC	and
BRF	NP	BRF
were	VBD	be
bribing	VBG	bribe
inspectors	NNS	inspector
to	TO	to
certify	VB	certify
meat	NN	meat
that	WDT	that
was	VBD	be
n't	RB	n't
safe	JJ	safe
for	IN	for
consumption	NN	consumption
.	SENT	.
Practices	NNS	practice
included	VBD	include
using	VBG	use
chemicals	NNS	chemical
to	TO	to
hide	VB	hide
the	DT	the
smell	NN	smell
and	CC	and
appearance	NN	appearance
of	IN	of
rotten	JJ	rotten
meat	NN	meat
,	,	,
mixing	VBG	mix
pigs	NNS	pig
'	POS	'
heads	NNS	head
into	IN	into
sausages	NNS	sausage
,	,	,
and	CC	and
even	RB	even
adding	VBG	add
cardboard	NN	cardboard
to	TO	to
chicken	NN	chicken
products	NNS	product
.	SENT	.
The	DT	the
fallout	NN	fallout
was	VBD	be
swift	JJ	swift
:	:	:
countries	NNS	country
including	VBG	include
China	NP	China
and	CC	and
the	DT	the
European	NP	European
Union	NP	Union
,	,	,
along	RB	along
with	IN	with
others	NNS	other
,	,	,
imposed	VBD	impose
bans	NNS	ban
on	IN	on
Brazilian	JJ	Brazilian
meat	NN	meat
imports	NNS	import
to	TO	to
protect	VB	protect
public	JJ	public
health	NN	health
.	SENT	.
This	DT	this
is	VBZ	be
n't	RB	n't
just	RB	just
a	DT	a
one-off	NN	one-off
issueâ€”it	NN	<unknown>
's	VBZ	be
a	DT	a
symptom	NN	symptom
of	IN	of
broader	JJR	broad
problems	NNS	problem
in	IN	in
global	JJ	global
industrial	JJ	industrial
meat	NN	meat
production	NN	production
.	SENT	.
The	DT	the
system	NN	system
is	VBZ	be
tied	VBN	tie
to	TO	to
outbreaks	NNS	outbreak
of	IN	of
diseases	NNS	disease
and	CC	and
significant	JJ	significant
environmental	JJ	environmental
damage	NN	damage
,	,	,
such	JJ	such
as	IN	as
widespread	JJ	widespread
deforestation	NN	deforestation
.	SENT	.
Industrial	JJ	industrial
meat	NN	meat
production	NN	production
contributes	VBZ	contribute
around	RB	around
14	CD	@card@
%	NN	%
of	IN	of
global	JJ	global
greenhouse	NN	greenhouse
gas	NN	gas
emissions	NNS	emission
.	SENT	.
At	IN	at
Greenpeace	NP	Greenpeace
,	,	,
we	PP	we
're	VBP	be
calling	VBG	call
for	IN	for
change	NN	change
.	SENT	.
Shifting	VBG	shift
to	TO	to
plant-rich	JJ	<unknown>
diets	NNS	diet
and	CC	and
eating	VBG	eat
less	JJR	less
meat	NN	meat
overall	RB	overall
can	MD	can
make	VB	make
a	DT	a
real	JJ	real
difference	NN	difference
.	SENT	.
We	PP	we
also	RB	also
need	VBP	need
to	TO	to
hold	VB	hold
governments	NNS	government
accountable	JJ	accountable
for	IN	for
regulating	VBG	regulate
the	DT	the
industry	NN	industry
better	RBR	well
.	SENT	.
Our	PP$	our
campaign	NN	campaign
pushes	VBZ	push
for	IN	for
meat	NN	meat
that	WDT	that
's	VBZ	be
sourced	VBN	<unknown>
locally	RB	locally
and	CC	and
sustainably	RB	<unknown>
,	,	,
ensuring	VBG	ensure
it	PP	it
's	VBZ	be
produced	VBN	produce
in	IN	in
ways	NNS	way
that	WDT	that
respect	VBP	respect
the	DT	the
planet	NN	planet
.	SENT	.
In	IN	in
a	DT	a
recent	JJ	recent
update	NN	update
to	TO	to
this	DT	this
story	NN	story
,	,	,
it	PP	it
's	VBZ	be
come	VBN	come
to	TO	to
light	VB	light
that	IN	that
these	DT	these
companies	NNS	company
have	VBP	have
been	VBN	be
purchasing	VBG	purchase
cattle	NNS	cattle
raised	VBN	raise
on	IN	on
lands	NNS	land
that	WDT	that
were	VBD	be
illegally	RB	illegally
deforested	VBN	deforest
,	,	,
further	RBR	further
fueling	VBG	fuel
environmental	JJ	environmental
destruction	NN	destruction
.	SENT	.
