As	IN	as
we	PP	we
face	VBP	face
the	DT	the
escalating	VBG	escalate
crisis	NN	crisis
of	IN	of
biodiversity	NN	biodiversity
loss	NN	loss
,	,	,
it	PP	it
's	VBZ	be
clear	JJ	clear
that	IN	that
protecting	VBG	protect
the	DT	the
rich	JJ	rich
web	NN	web
of	IN	of
life	NN	life
on	IN	on
our	PP$	our
planet	NN	planet
is	VBZ	be
essential	JJ	essential
for	IN	for
maintaining	VBG	maintain
a	DT	a
habitable	JJ	habitable
world	NN	world
.	SENT	.
Alarming	JJ	alarming
declines	NNS	decline
are	VBP	be
underway	JJ	underway
,	,	,
with	IN	with
forecasts	NNS	forecast
indicating	VBG	indicate
a	DT	a
two-thirds	JJ	two-thirds
drop	NN	drop
in	IN	in
animal	JJ	animal
species	NNS	specie
by	IN	by
2020	CD	@card@
compared	VBN	compare
to	TO	to
1970	CD	@card@
levels	NNS	level
.	SENT	.
At	IN	at
the	DT	the
Cancun	NP	Cancun
CBD	NN	CBD
summit	NN	summit
,	,	,
governments	NNS	government
must	MD	must
acknowledge	VB	acknowledge
their	PP$	their
failures	NNS	failure
and	CC	and
step	VB	step
up	RP	up
with	IN	with
bold	JJ	bold
commitments	NNS	commitment
to	TO	to
safeguard	VB	safeguard
vital	JJ	vital
areas	NNS	area
such	JJ	such
as	IN	as
the	DT	the
Great	NP	Great
Northern	NP	Northern
Forest	NP	Forest
and	CC	and
the	DT	the
Arctic	NP	Arctic
Ocean	NP	Ocean
.	SENT	.
Back	RB	back
in	IN	in
2010	CD	@card@
,	,	,
pledges	NNS	pledge
were	VBD	be
made	VBN	make
to	TO	to
protect	VB	protect
10	CD	@card@
%	NN	%
of	IN	of
oceans	NNS	ocean
and	CC	and
ensure	VB	ensure
sustainable	JJ	sustainable
forest	NN	forest
management	NN	management
by	IN	by
2020	CD	@card@
,	,	,
yet	RB	yet
these	DT	these
goals	NNS	goal
remain	VBP	remain
unmet	JJ	unmet
.	SENT	.
Today	NN	today
,	,	,
only	RB	only
3	CD	@card@
%	NN	%
of	IN	of
oceans	NNS	ocean
are	VBP	be
protected	VBN	protect
,	,	,
leaving	VBG	leave
vast	JJ	vast
marine	JJ	marine
ecosystems	NNS	ecosystem
vulnerable	JJ	vulnerable
.	SENT	.
Forests	NNS	forest
are	VBP	be
equally	RB	equally
at	IN	at
risk	NN	risk
,	,	,
including	VBG	include
the	DT	the
immense	JJ	immense
Great	NP	Great
Northern	NP	Northern
Forest	NP	Forest
,	,	,
which	WDT	which
supports	VBZ	support
communities	NNS	community
and	CC	and
countless	JJ	countless
species	NNS	specie
while	IN	while
serving	VBG	serve
as	IN	as
the	DT	the
planet	NN	planet
's	POS	's
largest	JJS	large
carbon	NN	carbon
store	NN	store
.	SENT	.
Threats	NNS	threat
from	IN	from
logging	NN	logging
,	,	,
fires	NNS	fire
,	,	,
and	CC	and
climate	NN	climate
change	NN	change
are	VBP	be
putting	VBG	put
this	DT	this
critical	JJ	critical
area	NN	area
in	IN	in
jeopardy	NN	jeopardy
.	SENT	.
It	PP	it
's	VBZ	be
time	NN	time
for	IN	for
all	DT	all
of	IN	of
us	PP	us
to	TO	to
take	VB	take
action	NN	action
and	CC	and
push	VB	push
for	IN	for
the	DT	the
fair	JJ	fair
sharing	NN	sharing
of	IN	of
resources	NNS	resource
to	TO	to
secure	VB	secure
a	DT	a
sustainable	JJ	sustainable
future	NN	future
.	SENT	.
