Nature	NP	Nature
&	CC	&
Youth	NP	Youth
and	CC	and
Greenpeace	NP	Greenpeace
Nordic	NN	Nordic
,	,	,
together	RB	together
with	IN	with
a	DT	a
coalition	NN	coalition
,	,	,
have	VBP	have
filed	VBN	file
a	DT	a
legal	JJ	legal
case	NN	case
against	IN	against
the	DT	the
Norwegian	JJ	Norwegian
government	NN	government
to	TO	to
halt	VB	halt
Arctic	NP	Arctic
oil	NN	oil
exploration	NN	exploration
by	IN	by
Statoil	NP	Statoil
.	SENT	.
The	DT	the
lawsuit	NN	lawsuit
is	VBZ	be
led	VBN	lead
by	IN	by
Ingrid	NP	Ingrid
Skjoldv√¶r	NP	<unknown>
and	CC	and
Truls	NP	Truls
Gulowsen	NP	<unknown>
.	SENT	.
It	PP	it
invokes	VBZ	invoke
Article	NP	Article
112	CD	@card@
of	IN	of
Norway	NP	Norway
's	POS	's
Constitution	NP	Constitution
,	,	,
which	WDT	which
guarantees	VBZ	guarantee
a	DT	a
healthy	JJ	healthy
environment	NN	environment
for	IN	for
future	JJ	future
generations	NNS	generation
,	,	,
and	CC	and
demands	NNS	demand
adherence	NN	adherence
to	TO	to
the	DT	the
Paris	NP	Paris
Agreement	NP	Agreement
's	POS	's
1.5-degree	JJ	<unknown>
warming	NN	warming
limit	NN	limit
.	SENT	.
The	DT	the
case	NN	case
highlights	VBZ	highlight
the	DT	the
contradiction	NN	contradiction
of	IN	of
Norway	NP	Norway
's	POS	's
emission	NN	emission
reduction	NN	reduction
promises	VBZ	promise
amid	IN	amid
new	JJ	new
Barents	NP	Barents
Sea	NP	Sea
drilling	NN	drilling
plans	NNS	plan
.	SENT	.
It	PP	it
emphasizes	VBZ	emphasize
the	DT	the
need	NN	need
to	TO	to
keep	VB	keep
80	CD	@card@
%	NN	%
of	IN	of
fossil	JJ	fossil
fuels	NNS	fuel
underground	JJ	underground
to	TO	to
avert	VB	avert
climate	NN	climate
catastrophe	NN	catastrophe
.	SENT	.
This	DT	this
people-powered	JJ	<unknown>
action	NN	action
aims	VBZ	aim
to	TO	to
protect	VB	protect
the	DT	the
Arctic	NP	Arctic
and	CC	and
inspire	VB	inspire
global	JJ	global
resistance	NN	resistance
against	IN	against
fossil	JJ	fossil
fuels	NNS	fuel
.	SENT	.
