Jennifer	NP	Jennifer
Morgan	NP	Morgan
,	,	,
Greenpeace	NP	Greenpeace
International	NP	International
's	POS	's
Executive	NP	Executive
Director	NP	Director
,	,	,
visited	VBD	visit
Svalbard	NP	Svalbard
to	TO	to
observe	VB	observe
rapid	JJ	rapid
Arctic	NP	Arctic
changes	NNS	change
from	IN	from
climate	NN	climate
change	NN	change
,	,	,
including	VBG	include
melting	VBG	melt
ice	NN	ice
and	CC	and
warming	NN	warming
temperatures	NNS	temperature
.	SENT	.
She	PP	she
highlights	VBZ	highlight
industrial	JJ	industrial
fishing	NN	fishing
's	POS	's
role	NN	role
in	IN	in
polluting	VBG	pollute
shores	NNS	shore
with	IN	with
trash	NN	trash
,	,	,
mostly	RB	mostly
from	IN	from
fisheries	NNS	fishery
,	,	,
harming	VBG	harm
wildlife	NN	wildlife
like	IN	like
reindeer	NN	reindeer
,	,	,
polar	JJ	polar
bears	NNS	bear
,	,	,
and	CC	and
seabirds	NNS	seabird
through	IN	through
entanglement	NN	entanglement
and	CC	and
ingestion	NN	ingestion
.	SENT	.
A	DT	a
beach	NN	beach
clean-up	NN	clean-up
under	IN	under
the	DT	the
‘	``	'
Protect	VB	protect
What	WP	what
You	PP	you
Love	NP	Love
’	POS	'
campaign	NN	campaign
raised	VBD	raise
awareness	NN	awareness
of	IN	of
destructive	JJ	destructive
bottom	NN	bottom
trawling	VBG	trawl
.	SENT	.
She	PP	she
notes	VBZ	note
a	DT	a
voluntary	JJ	voluntary
industry	NN	industry
agreement	NN	agreement
,	,	,
brokered	VBD	broker
by	IN	by
Greenpeace	NP	Greenpeace
,	,	,
to	TO	to
avoid	VB	avoid
expanding	VBG	expand
cod	NN	cod
fishing	NN	fishing
into	IN	into
untouched	JJ	untouched
northern	JJ	northern
Barents	NP	Barents
Sea	NP	Sea
areas	NNS	area
,	,	,
but	CC	but
urges	VBZ	urge
Norway	NP	Norway
to	TO	to
establish	VB	establish
legal	JJ	legal
marine	JJ	marine
protections	NNS	protection
.	SENT	.
