On	IN	on
May	NP	May
18	CD	@card@
,	,	,
2016	CD	@card@
,	,	,
Norway	NP	Norway
granted	VBD	grant
new	JJ	new
Arctic	NP	Arctic
drilling	NN	drilling
licenses	NNS	license
to	TO	to
13	CD	@card@
oil	NN	oil
companies	NNS	company
.	SENT	.
The	DT	the
petroleum	NN	petroleum
minister	NN	minister
hailed	VBD	hail
this	DT	this
as	IN	as
a	DT	a
"	``	"
new	JJ	new
chapter	NN	chapter
"	''	"
despite	IN	despite
industry	NN	industry
setbacks	NNS	setback
like	IN	like
Shell	NP	Shell
's	POS	's
withdrawal	NN	withdrawal
,	,	,
halved	JJ	halved
Norwegian	JJ	Norwegian
production	NN	production
,	,	,
and	CC	and
plummeting	VBG	plummet
oil	NN	oil
prices	NNS	price
.	SENT	.
This	DT	this
decision	NN	decision
contradicts	VBZ	contradict
recent	JJ	recent
global	JJ	global
warming	NN	warming
limits	NNS	limit
from	IN	from
the	DT	the
Paris	NP	Paris
Agreement	NP	Agreement
and	CC	and
a	DT	a
Norway-US	NP	<unknown>
Arctic	NP	Arctic
sustainability	NN	sustainability
deal	NN	deal
.	SENT	.
Chevron	NP	Chevron
's	POS	's
CEO	NN	CEO
views	NNS	view
warming	VBG	warm
as	RB	as
beneficial	JJ	beneficial
for	IN	for
gas	NN	gas
production	NN	production
.	SENT	.
Civil	JJ	civil
society	NN	society
groups	NNS	group
,	,	,
including	VBG	include
Greenpeace	NP	Greenpeace
,	,	,
seek	VBP	seek
a	DT	a
constitutional	JJ	constitutional
review	NN	review
for	IN	for
environmental	JJ	environmental
rights	NNS	right
,	,	,
potentially	RB	potentially
leading	VBG	lead
to	TO	to
court	NN	court
action	NN	action
,	,	,
offering	VBG	offer
hope	NN	hope
for	IN	for
a	DT	a
shift	NN	shift
to	TO	to
renewables	NNS	<unknown>
over	IN	over
Arctic	NP	Arctic
oil	NN	oil
.	SENT	.
