Out	RB	out
in	IN	in
the	DT	the
vast	JJ	vast
expanse	NN	expanse
of	IN	of
the	DT	the
Indian	NP	Indian
Ocean	NP	Ocean
,	,	,
Greenpeace	NP	Greenpeace
's	POS	's
ship	NN	ship
Esperanza	NP	Esperanza
is	VBZ	be
making	VBG	make
waves	NNS	wave
in	IN	in
the	DT	the
fight	NN	fight
against	IN	against
destructive	JJ	destructive
fishing	NN	fishing
.	SENT	.
Armed	VBN	arm
with	IN	with
its	PP$	its
impressive	JJ	impressive
reach	NN	reach
and	CC	and
cutting-edge	NN	cutting-edge
technology—like	JJ	<unknown>
solar-powered	JJ	solar-powered
UAVs	NP	<unknown>
,	,	,
an	DT	an
underwater	JJ	underwater
ROV	NP	<unknown>
,	,	,
and	CC	and
powerful	JJ	powerful
binoculars—the	NN	<unknown>
crew	NN	crew
is	VBZ	be
actively	RB	actively
locating	VBG	locate
and	CC	and
removing	VBG	remove
dozens	NNS	dozen
of	IN	of
Fish	NP	Fish
Aggregating	VBG	aggregate
Devices	NPS	Devices
(	(	(
FADs	NNS	fad
)	)	)
.	SENT	.
These	DT	these
efforts	NNS	effort
are	VBP	be
crucial	JJ	crucial
in	IN	in
preventing	VBG	prevent
the	DT	the
tragic	JJ	tragic
bycatch	NN	bycatch
deaths	NNS	death
caused	VBN	cause
by	IN	by
reckless	JJ	reckless
fishing	NN	fishing
vessels	NNS	vessel
that	WDT	that
supply	VBP	supply
Thai	NP	Thai
Union	NP	Union
.	SENT	.
Once	RB	once
retrieved	VBN	retrieve
,	,	,
the	DT	the
FAD	NN	fad
components	NNS	component
are	VBP	be
n't	RB	n't
just	RB	just
discarded	VBN	discard
;	:	;
they	PP	they
're	VBP	be
given	VBN	give
back	RB	back
to	TO	to
local	JJ	local
artisanal	JJ	<unknown>
fishermen	NNS	fisherman
or	CC	or
cleverly	RB	cleverly
repurposed	JJ	<unknown>
into	IN	into
solar-powered	JJ	solar-powered
lamps	NNS	lamp
and	CC	and
chargers	NNS	charger
.	SENT	.
Through	IN	through
these	DT	these
actions	NNS	action
,	,	,
we	PP	we
're	VBP	be
directly	RB	directly
challenging	VBG	challenge
Thai	NP	Thai
Union	NP	Union
's	POS	's
harmful	JJ	harmful
practices	NNS	practice
right	RB	right
at	IN	at
sea	NN	sea
,	,	,
and	CC	and
we	PP	we
're	VBP	be
not	RB	not
stopping	VBG	stop
there—more	RB	<unknown>
efforts	NNS	effort
are	VBP	be
planned	VBN	plan
on	IN	on
land	NN	land
to	TO	to
keep	VB	keep
pushing	VBG	push
for	IN	for
change	NN	change
.	SENT	.
