Thor	NP	Thor
S.	NP	S.
Larsen	NP	Larsen
has	VBZ	have
been	VBN	be
a	DT	a
pioneer	NN	pioneer
in	IN	in
polar	JJ	polar
bear	NN	bear
research	NN	research
since	IN	since
1965	CD	@card@
.	SENT	.
He	PP	he
has	VBZ	have
shared	VBN	share
his	PP$	his
experiences	NNS	experience
studying	VBG	study
over	IN	over
2,000	CD	@card@
bears	NNS	bear
,	,	,
including	VBG	include
magical	JJ	magical
moments	NNS	moment
like	IN	like
maternity	NN	maternity
den	NN	den
surveys	NNS	survey
in	IN	in
the	DT	the
Arctic	NP	Arctic
.	SENT	.
As	IN	as
a	DT	a
member	NN	member
of	IN	of
the	DT	the
IUCN	NP	<unknown>
Polar	JJ	polar
Bear	NP	Bear
Specialist	NN	specialist
Group	NP	Group
,	,	,
he	PP	he
helped	VBD	help
initiate	VB	initiate
the	DT	the
1973	CD	@card@
Agreement	NN	agreement
on	IN	on
the	DT	the
Conservation	NP	Conservation
of	IN	of
Polar	JJ	polar
Bears	NNS	bear
,	,	,
which	WDT	which
bans	VBZ	ban
most	JJS	most
hunting	NN	hunting
with	IN	with
exceptions	NNS	exception
for	IN	for
indigenous	JJ	indigenous
communities	NNS	community
.	SENT	.
Today	NN	today
,	,	,
polar	JJ	polar
bears	NNS	bear
face	VBP	face
threats	NNS	threat
from	IN	from
retreating	VBG	retreat
sea	NN	sea
ice	NN	ice
,	,	,
which	WDT	which
hinders	VBZ	hinder
their	PP$	their
hunting	NN	hunting
and	CC	and
reproduction	NN	reproduction
.	SENT	.
Den	NN	den
numbers	NNS	number
are	VBP	be
declining	VBG	decline
in	IN	in
areas	NNS	area
like	IN	like
Kong	NP	Kong
Karls	NP	Karls
Land	NP	Land
and	CC	and
Wrangel	NP	Wrangel
Island	NP	Island
,	,	,
and	CC	and
pollution	NN	pollution
is	VBZ	be
also	RB	also
a	DT	a
concern	NN	concern
.	SENT	.
Many	JJ	many
subpopulations	NNS	subpopulation
are	VBP	be
declining	VBG	decline
,	,	,
requiring	VBG	require
international	JJ	international
action	NN	action
on	IN	on
climate	NN	climate
change	NN	change
and	CC	and
pollution	NN	pollution
,	,	,
plus	CC	plus
protections	NNS	protection
for	IN	for
denning	VBG	den
areas	NNS	area
.	SENT	.
