Our	PP$	our
oceans	NNS	ocean
are	VBP	be
facing	VBG	face
a	DT	a
severe	JJ	severe
crisis	NN	crisis
from	IN	from
plastic	JJ	plastic
pollution	NN	pollution
,	,	,
with	IN	with
eight	CD	eight
million	CD	million
tonnes	NNS	tonne
of	IN	of
plastic	NN	plastic
entering	VBG	enter
them	PP	them
every	DT	every
year	NN	year
,	,	,
transforming	VBG	transform
these	DT	these
vital	JJ	vital
waters	NNS	water
into	IN	into
what	WP	what
can	MD	can
only	RB	only
be	VB	be
described	VBN	describe
as	IN	as
"	``	"
plastic	JJ	plastic
soup	NN	soup
.	SENT	.
"	''	"
Disposable	JJ	disposable
plastics	NNS	plastic
do	VBP	do
n't	RB	n't
just	RB	just
disappear	VB	disappear
;	:	;
they	PP	they
persist	VBP	persist
in	IN	in
the	DT	the
environment	NN	environment
,	,	,
breaking	VBG	break
down	RP	down
into	IN	into
tiny	JJ	tiny
microplastics	NNS	microplastic
that	WDT	that
infiltrate	VBP	infiltrate
food	NN	food
chains	NNS	chain
and	CC	and
end	VB	end
up	RP	up
in	IN	in
the	DT	the
fish	NN	fish
we	PP	we
eat	VBP	eat
and	CC	and
even	RB	even
in	IN	in
sea	NN	sea
salt	NN	salt
.	SENT	.
Meanwhile	RB	meanwhile
,	,	,
larger	JJR	large
plastic	NN	plastic
pieces	NNS	piece
are	VBP	be
deadly	JJ	deadly
,	,	,
killing	VBG	kill
seabirds	NNS	seabird
,	,	,
fish	NN	fish
,	,	,
turtles	NNS	turtle
,	,	,
and	CC	and
whales	NNS	whale
either	RB	either
by	IN	by
being	VBG	be
ingested	VBN	ingest
or	CC	or
through	IN	through
entanglement	NN	entanglement
.	SENT	.
To	TO	to
combat	VB	combat
this	DT	this
,	,	,
we	PP	we
must	MD	must
embrace	VB	embrace
the	DT	the
principles	NNS	principle
of	IN	of
"	``	"
Reduce	VB	reduce
,	,	,
Reuse	VB	reuse
,	,	,
Recycle	VB	recycle
.	SENT	.
"	''	"
Here	RB	here
are	VBP	be
five	CD	five
practical	JJ	practical
actions	NNS	action
you	PP	you
can	MD	can
take	VB	take
:	:	:
refuse	VB	refuse
single-use	NN	<unknown>
plastics	NNS	plastic
such	JJ	such
as	IN	as
bags	NNS	bag
and	CC	and
straws	NNS	straw
;	:	;
avoid	VB	avoid
cosmetics	NNS	cosmetic
containing	VBG	contain
microbeads	NNS	microbead
;	:	;
buy	VB	buy
plastics	NNS	plastic
responsibly	RB	responsibly
and	CC	and
recycle	VB	recycle
them	PP	them
,	,	,
while	IN	while
advocating	VBG	advocate
for	IN	for
better	JJR	good
recycling	NN	recycling
facilities	NNS	facility
if	IN	if
they	PP	they
're	VBP	be
lacking	VBG	lack
in	IN	in
your	PP$	your
area	NN	area
;	:	;
participate	VB	participate
in	IN	in
beach	NN	beach
clean-up	JJ	clean-up
events	NNS	event
;	:	;
and	CC	and
encourage	VB	encourage
friends	NNS	friend
,	,	,
family	NN	family
,	,	,
and	CC	and
your	PP$	your
community	NN	community
to	TO	to
join	VB	join
in	IN	in
these	DT	these
efforts	NNS	effort
.	SENT	.
