The	DT	the
World	NP	World
Health	NP	Health
Organization	NP	Organization
(	(	(
WHO	WP	who
)	)	)
classifies	VBZ	classify
processed	JJ	processed
meat	NN	meat
as	IN	as
carcinogenic	JJ	carcinogenic
and	CC	and
red	JJ	red
meat	NN	meat
as	IN	as
probably	RB	probably
carcinogenic	JJ	carcinogenic
,	,	,
which	WDT	which
raises	VBZ	raise
significant	JJ	significant
concerns	NNS	concern
about	IN	about
current	JJ	current
levels	NNS	level
of	IN	of
meat	NN	meat
consumption	NN	consumption
.	SENT	.
Producing	VBG	produce
the	DT	the
meat	NN	meat
and	CC	and
dairy	NN	dairy
for	IN	for
just	RB	just
one	CD	one
person	NN	person
's	POS	's
annual	JJ	annual
needs	NNS	need
requires	VBZ	require
403,000	CD	@card@
liters	NNS	liter
of	IN	of
water	NN	water
,	,	,
an	DT	an
amount	NN	amount
equivalent	NN	equivalent
to	TO	to
taking	VBG	take
6,190	CD	@card@
showers	NNS	shower
.	SENT	.
In	IN	in
2011	CD	@card@
,	,	,
8,481	CD	@card@
tons	NNS	ton
of	IN	of
antibiotics	NNS	antibiotic
were	VBD	be
sold	VBN	sell
for	IN	for
use	NN	use
in	IN	in
EU	NP	EU
livestock	NN	livestock
.	SENT	.
Animal	JJ	animal
agriculture	NN	agriculture
involves	VBZ	involve
breeding	VBG	breed
1	CD	@card@
billion	NN	billion
pigs	NNS	pig
,	,	,
19	CD	@card@
billion	NN	billion
chickens	NNS	chicken
,	,	,
and	CC	and
1.4	CD	@card@
billion	NN	billion
cattle	NNS	cattle
,	,	,
and	CC	and
it	PP	it
is	VBZ	be
responsible	JJ	responsible
for	IN	for
80	CD	@card@
%	NN	%
of	IN	of
deforestation	NN	deforestation
in	IN	in
the	DT	the
Amazon	NP	Amazon
as	RB	as
well	RB	well
as	IN	as
emitting	VBG	emit
more	JJR	more
greenhouse	NN	greenhouse
gases	NNS	gas
than	IN	than
the	DT	the
entire	JJ	entire
transport	NN	transport
sector	NN	sector
.	SENT	.
This	DT	this
industry	NN	industry
also	RB	also
uses	VBZ	use
80	CD	@card@
%	NN	%
of	IN	of
global	JJ	global
soy	NN	soy
production	NN	production
for	IN	for
animal	JJ	animal
feed	NN	feed
.	SENT	.
To	TO	to
address	VB	address
these	DT	these
issues	NNS	issue
,	,	,
consider	VBP	consider
reducing	VBG	reduce
your	PP$	your
weekly	JJ	weekly
meat	NN	meat
intake	NN	intake
by	IN	by
half	NN	half
and	CC	and
incorporating	VBG	incorporate
more	RBR	more
local	JJ	local
fruits	NNS	fruit
and	CC	and
vegetables	NNS	vegetable
,	,	,
which	WDT	which
can	MD	can
offer	VB	offer
benefits	NNS	benefit
for	IN	for
health	NN	health
,	,	,
ethics	NNS	ethic
,	,	,
and	CC	and
the	DT	the
environment	NN	environment
.	SENT	.
