Greenpeace	NP	Greenpeace
is	VBZ	be
thrilled	VBN	thrill
to	TO	to
celebrate	VB	celebrate
a	DT	a
monumental	JJ	monumental
victory	NN	victory
achieved	VBN	achieve
by	IN	by
dedicated	JJ	dedicated
activists	NNS	activist
,	,	,
petitioners	NNS	petitioner
,	,	,
and	CC	and
global	JJ	global
supporters	NNS	supporter
who	WP	who
compelled	VBD	compel
Shell	NP	Shell
to	TO	to
abandon	VB	abandon
its	PP$	its
Arctic	NP	Arctic
drilling	NN	drilling
plans	NNS	plan
.	SENT	.
Through	IN	through
relentless	JJ	relentless
protests	NNS	protest
,	,	,
widespread	JJ	widespread
petitions	NNS	petition
,	,	,
and	CC	and
immense	JJ	immense
public	JJ	public
pressure	NN	pressure
,	,	,
this	DT	this
effort	NN	effort
transformed	VBD	transform
what	WP	what
was	VBD	be
once	RB	once
just	RB	just
a	DT	a
corporate	JJ	corporate
agenda	NN	agenda
into	IN	into
major	JJ	major
headlines	NNS	headline
,	,	,
proving	VBG	prove
that	DT	that
people	NNS	people
power	NN	power
can	MD	can
triumph	VB	triumph
over	IN	over
profits	NNS	profit
.	SENT	.
Shell	NP	Shell
's	POS	's
decision	NN	decision
came	VBD	come
after	IN	after
acknowledging	VBG	acknowledge
the	DT	the
enormous	JJ	enormous
high	JJ	high
costs	NNS	cost
involved—over	NN	<unknown>
$7	JJ	<unknown>
billion	NNS	billion
already	RB	already
spent—along	JJ	<unknown>
with	IN	with
insufficient	JJ	insufficient
oil	NN	oil
discoveries	NNS	discovery
,	,	,
a	DT	a
tough	JJ	tough
regulatory	JJ	regulatory
environment	NN	environment
shaped	VBN	shape
by	IN	by
worldwide	JJ	worldwide
opposition	NN	opposition
,	,	,
and	CC	and
significant	JJ	significant
risks	NNS	risk
,	,	,
including	VBG	include
a	DT	a
75	CD	@card@
%	NN	%
chance	NN	chance
of	IN	of
oil	NN	oil
spills	NNS	spill
.	SENT	.
The	DT	the
environmental	JJ	environmental
dangers	NNS	danger
at	IN	at
stake	NN	stake
are	VBP	be
profound	JJ	profound
,	,	,
encompassing	VBG	encompass
the	DT	the
acceleration	NN	acceleration
of	IN	of
Arctic	NP	Arctic
melting	NN	melting
,	,	,
the	DT	the
displacement	NN	displacement
of	IN	of
communities	NNS	community
,	,	,
and	CC	and
harm	VB	harm
to	TO	to
wildlife	NN	wildlife
.	SENT	.
Yet	RB	yet
,	,	,
the	DT	the
fight	NN	fight
is	VBZ	be
far	RB	far
from	IN	from
over	RB	over
.	SENT	.
We	PP	we
must	MD	must
push	VB	push
forward	RB	forward
for	IN	for
permanent	JJ	permanent
protection	NN	protection
of	IN	of
the	DT	the
Arctic	NP	Arctic
against	IN	against
drilling	VBG	drill
by	IN	by
all	DT	all
oil	NN	oil
companies	NNS	company
.	SENT	.
