Greenpeace	NP	Greenpeace
is	VBZ	be
excited	VBN	excite
to	TO	to
host	VB	host
the	DT	the
largest	JJS	large
clothes	NNS	clothes
swap	VBP	swap
party	NN	party
in	IN	in
Austria	NP	Austria
and	CC	and
Germany	NP	Germany
,	,	,
bringing	VBG	bring
together	RB	together
communities	NNS	community
across	IN	across
over	IN	over
40	CD	@card@
cities	NNS	city
.	SENT	.
With	IN	with
10,000	CD	@card@
participants	NNS	participant
expected	VBN	expect
,	,	,
the	DT	the
event	NN	event
aims	VBZ	aim
to	TO	to
facilitate	VB	facilitate
the	DT	the
exchange	NN	exchange
of	IN	of
50,000	CD	@card@
items	NNS	item
,	,	,
highlighting	VBG	highlight
practical	JJ	practical
ways	NNS	way
to	TO	to
move	VB	move
beyond	IN	beyond
fast	JJ	fast
fashion	NN	fashion
.	SENT	.
This	DT	this
initiative	NN	initiative
is	VBZ	be
a	DT	a
key	JJ	key
part	NN	part
of	IN	of
our	PP$	our
Detox	NN	Detox
campaign	NN	campaign
,	,	,
which	WDT	which
pushes	VBZ	push
for	IN	for
clean	JJ	clean
textile	NN	textile
production	NN	production
.	SENT	.
By	IN	by
encouraging	JJ	encouraging
alternatives	NNS	alternative
like	IN	like
reselling	VBG	resell
,	,	,
repairing	VBG	repair
,	,	,
and	CC	and
buying	VBG	buy
organic	JJ	organic
clothes	NNS	clothes
,	,	,
we	PP	we
're	VBP	be
addressing	VBG	address
the	DT	the
growing	VBG	grow
challenges	NNS	challenge
in	IN	in
the	DT	the
industry	NN	industry
.	SENT	.
Clothing	NN	clothing
consumption	NN	consumption
doubles	VBZ	double
every	DT	every
decade	NN	decade
,	,	,
and	CC	and
cheap	JJ	cheap
items	NNS	item
are	VBP	be
frequently	RB	frequently
discarded	VBN	discard
after	IN	after
just	RB	just
a	DT	a
few	JJ	few
uses	NNS	use
,	,	,
ending	VBG	end
up	RP	up
in	IN	in
landfills	NNS	landfill
or	CC	or
incinerators	NNS	incinerator
.	SENT	.
The	DT	the
textile	JJ	textile
industry	NN	industry
also	RB	also
contributes	VBZ	contribute
to	TO	to
freshwater	NN	freshwater
pollution	NN	pollution
,	,	,
particularly	RB	particularly
in	IN	in
places	NNS	place
like	IN	like
China	NP	China
.	SENT	.
To	TO	to
counter	VB	counter
this	DT	this
,	,	,
options	NNS	option
such	JJ	such
as	IN	as
renting	VBG	rent
,	,	,
sharing	VBG	share
,	,	,
and	CC	and
swapping	VBG	swap
are	VBP	be
gaining	VBG	gain
traction	NN	traction
.	SENT	.
Secondhand	JJ	secondhand
and	CC	and
eco-fashion	NN	eco-fashion
choices	NNS	choice
are	VBP	be
expanding	VBG	expand
,	,	,
and	CC	and
you	PP	you
can	MD	can
find	VB	find
them	PP	them
through	IN	through
an	DT	an
interactive	JJ	interactive
map	NN	map
that	WDT	that
makes	VBZ	make
these	DT	these
sustainable	JJ	sustainable
alternatives	NNS	alternative
more	RBR	more
accessible	JJ	accessible
.	SENT	.
