The	DT	the
Arctic	NP	Arctic
30—Greenpeace	JJ	<unknown>
activists	NNS	activist
,	,	,
journalists	NNS	journalist
,	,	,
and	CC	and
crew—were	NN	<unknown>
arrested	VBN	arrest
by	IN	by
Russia	NP	Russia
during	IN	during
a	DT	a
peaceful	JJ	peaceful
protest	NN	protest
against	IN	against
Gazprom	NP	<unknown>
's	POS	's
Arctic	NP	Arctic
oil	NN	oil
platform	NN	platform
.	SENT	.
Global	JJ	global
support	NN	support
for	IN	for
their	PP$	their
release	NN	release
has	VBZ	have
surged	VBN	surge
,	,	,
with	IN	with
families	NNS	family
launching	VBG	launch
petitions	NNS	petition
,	,	,
websites	NNS	website
,	,	,
and	CC	and
pickets	VBZ	picket
to	TO	to
rally	VB	rally
attention	NN	attention
.	SENT	.
This	DT	this
wave	NN	wave
of	IN	of
solidarity	NN	solidarity
includes	VBZ	include
Nobel	NP	Nobel
laureates	NNS	laureate
and	CC	and
leaders	NNS	leader
such	JJ	such
as	IN	as
Angela	NP	Angela
Merkel	NP	Merkel
and	CC	and
Hillary	NP	Hillary
Clinton	NP	Clinton
,	,	,
alongside	IN	alongside
organizations	NNS	organization
that	WDT	that
have	VBP	have
sent	VBN	send
1.5	CD	@card@
million	CD	million
emails	NNS	email
and	CC	and
gathered	VBD	gather
a	DT	a
million	CD	million
signatures	NNS	signature
in	IN	in
their	PP$	their
defense	NN	defense
.	SENT	.
The	DT	the
Netherlands	NP	Netherlands
has	VBZ	have
taken	VBN	take
action	NN	action
by	IN	by
seeking	VBG	seek
their	PP$	their
release	NN	release
through	IN	through
the	DT	the
International	NP	International
Tribunal	NP	Tribunal
for	IN	for
the	DT	the
Law	NN	law
of	IN	of
the	DT	the
Sea	NP	Sea
.	SENT	.
These	DT	these
individuals	NNS	individual
stand	VBP	stand
as	IN	as
heroes	NNS	hero
in	IN	in
the	DT	the
tradition	NN	tradition
of	IN	of
non-violent	JJ	non-violent
resistance	NN	resistance
,	,	,
facing	VBG	face
Russia	NP	Russia
's	POS	's
overreaction	NN	overreaction
and	CC	and
frivolous	JJ	frivolous
charges	NNS	charge
like	IN	like
piracy	NN	piracy
and	CC	and
hooliganism	NN	hooliganism
.	SENT	.
Such	JJ	such
responses	NNS	response
may	MD	may
ultimately	RB	ultimately
strengthen	VB	strengthen
the	DT	the
climate	NN	climate
movement	NN	movement
by	IN	by
drawing	VBG	draw
greater	JJR	great
awareness	NN	awareness
to	TO	to
the	DT	the
cause	NN	cause
.	SENT	.
