Uniqlo	NP	<unknown>
has	VBZ	have
committed	VBN	commit
to	TO	to
eliminating	VBG	eliminate
all	DT	all
releases	NNS	release
of	IN	of
hazardous	JJ	hazardous
chemicals	NNS	chemical
from	IN	from
its	PP$	its
global	JJ	global
supply	NN	supply
chain	NN	chain
and	CC	and
products	NNS	product
by	IN	by
2020	CD	@card@
.	SENT	.
This	DT	this
follows	VBZ	follow
similar	JJ	similar
pledges	NNS	pledge
from	IN	from
Zara	NP	Zara
,	,	,
Mango	NP	Mango
,	,	,
Esprit	NN	esprit
,	,	,
and	CC	and
Levi	NP	Levi
â€™s	POS	's
.	SENT	.
The	DT	the
move	NN	move
comes	VBZ	come
from	IN	from
Uniqlo	NP	<unknown>
's	POS	's
parent	NN	parent
company	NN	company
,	,	,
Fast	JJ	fast
Retailing	NN	retailing
Group	NP	Group
.	SENT	.
It	PP	it
includes	VBZ	include
disclosing	VBG	disclose
discharge	NN	discharge
data	NNS	datum
from	IN	from
80	CD	@card@
%	NN	%
of	IN	of
suppliers	NNS	supplier
in	IN	in
2013	CD	@card@
and	CC	and
leading	VBG	lead
the	DT	the
development	NN	development
of	IN	of
alternatives	NNS	alternative
to	TO	to
hazardous	JJ	hazardous
chemicals	NNS	chemical
.	SENT	.
The	DT	the
commitment	NN	commitment
covers	VBZ	cover
brands	NNS	brand
like	IN	like
Comptoir	NP	<unknown>
des	NP	des
Cotonniers	NP	<unknown>
and	CC	and
Theory	NN	theory
,	,	,
benefiting	VBG	benefit
communities	NNS	community
affected	VBN	affect
by	IN	by
pollution	NN	pollution
.	SENT	.
Share	NN	share
the	DT	the
Detox	NN	Detox
Fashion	NN	fashion
video	NN	video
to	TO	to
pressure	VB	pressure
lagging	VBG	lag
brands	NNS	brand
like	IN	like
GAP	NN	gap
and	CC	and
Calvin	NP	Calvin
Klein	NP	Klein
toward	IN	toward
transparent	JJ	transparent
,	,	,
toxic-free	JJ	<unknown>
practices	NNS	practice
.	SENT	.
