Kenyan	JJ	Kenyan
smallholder	NN	smallholder
farmers	NNS	farmer
are	VBP	be
challenging	VBG	challenge
unconstitutional	JJ	unconstitutional
laws	NNS	law
that	WDT	that
prohibit	VBP	prohibit
them	PP	them
from	IN	from
sharing	NN	sharing
,	,	,
exchanging	VBG	exchange
,	,	,
or	CC	or
selling	VBG	sell
uncertified	JJ	uncertified
seeds	NNS	seed
.	SENT	.
These	DT	these
laws	NNS	law
,	,	,
which	WDT	which
favor	VBP	favor
multinational	JJ	multinational
corporations	NNS	corporation
within	IN	within
a	DT	a
broken	VBN	break
global	JJ	global
food	NN	food
system	NN	system
,	,	,
carry	VB	carry
punishments	NNS	punishment
of	IN	of
up	IN	up
to	TO	to
two	CD	two
years	NNS	year
in	IN	in
prison	NN	prison
or	CC	or
a	DT	a
KES	NP	KES
1,000,000	CD	@card@
fine	NN	fine
for	IN	for
offenders	NNS	offender
.	SENT	.
In	IN	in
response	NN	response
,	,	,
activists	NNS	activist
are	VBP	be
taking	VBG	take
action	NN	action
.	SENT	.
Nasike	NP	<unknown>
leads	VBZ	lead
Greenpeace	NP	Greenpeace
Africa	NP	Africa
's	POS	's
Seed	NP	Seed
is	VBZ	be
Sovereign	NP	Sovereign
campaign	NN	campaign
,	,	,
which	WDT	which
works	VBZ	work
to	TO	to
protect	VB	protect
seed	NN	seed
sovereignty	NN	sovereignty
and	CC	and
supports	VBZ	support
the	DT	the
Kenyan	JJ	Kenyan
court	NN	court
case	NN	case
.	SENT	.
In	IN	in
Cameroon	NP	Cameroon
,	,	,
Darcise	NP	<unknown>
Dolor√®s	NP	<unknown>
,	,	,
an	DT	an
environmental	JJ	environmental
law	NN	law
student	NN	student
and	CC	and
Greenpeace	NP	Greenpeace
volunteer	NN	volunteer
,	,	,
is	VBZ	be
applying	VBG	apply
the	DT	the
South	JJ	South
African	JJ	African
rooibos	NNS	<unknown>
case	NN	case
to	TO	to
safeguard	VB	safeguard
Indigenous	JJ	indigenous
access	NN	access
to	TO	to
palm	VB	palm
oil	NN	oil
.	SENT	.
Delwyn	NP	Delwyn
,	,	,
a	DT	a
South	JJ	South
African	JJ	African
activist	NN	activist
,	,	,
coordinates	VBZ	coordinate
Greenpeace	NP	Greenpeace
volunteers	NNS	volunteer
and	CC	and
founded	VBD	found
Food	NP	Food
Connect	VBP	connect
Durban	NP	Durban
.	SENT	.
This	DT	this
organization	NN	organization
promotes	VBZ	promote
local	JJ	local
sustainable	JJ	sustainable
food	NN	food
and	CC	and
the	DT	the
saving	NN	saving
of	IN	of
heirloom	NN	heirloom
seeds	NNS	seed
,	,	,
and	CC	and
its	PP$	its
work	NN	work
is	VBZ	be
aligned	VBN	align
with	IN	with
global	JJ	global
movements	NNS	movement
.	SENT	.
