Nature	NN	nature
is	VBZ	be
collapsing	VBG	collapse
due	JJ	due
to	TO	to
rampant	JJ	rampant
deforestation	NN	deforestation
.	SENT	.
At	IN	at
the	DT	the
upcoming	JJ	upcoming
COP15	NP	<unknown>
summit	NN	summit
in	IN	in
Montreal	NP	Montreal
,	,	,
leaders	NNS	leader
have	VBP	have
a	DT	a
chance	NN	chance
to	TO	to
protect	VB	protect
biodiversity	NN	biodiversity
by	IN	by
recognizing	VBG	recognize
the	DT	the
rights	NNS	right
of	IN	of
Indigenous	JJ	indigenous
Peoples	NPS	Peoples
.	SENT	.
This	DT	this
must	MD	must
include	VB	include
creating	VBG	create
a	DT	a
new	JJ	new
conservation	NN	conservation
category	NN	category
for	IN	for
their	PP$	their
lands	NNS	land
,	,	,
where	WRB	where
they	PP	they
lead	VBP	lead
both	DT	both
decision-making	NN	decision-making
and	CC	and
funding	NN	funding
.	SENT	.
The	DT	the
current	JJ	current
model	NN	model
of	IN	of
"	``	"
fortress	NN	fortress
conservation	NN	conservation
"	``	"
must	MD	must
be	VB	be
rejected	VBN	reject
.	SENT	.
This	DT	this
approach	NN	approach
excludes	VBZ	exclude
local	JJ	local
communities	NNS	community
and	CC	and
is	VBZ	be
a	DT	a
form	NN	form
of	IN	of
colonialism	NN	colonialism
,	,	,
leading	VBG	lead
to	TO	to
abuses	NNS	abuse
such	JJ	such
as	IN	as
violence	NN	violence
in	IN	in
Tanzania	NP	Tanzania
and	CC	and
Central	NP	Central
Africa	NP	Africa
.	SENT	.
In	IN	in
contrast	NN	contrast
,	,	,
data	NN	data
shows	VBZ	show
that	IN	that
Indigenous	JJ	indigenous
management	NN	management
of	IN	of
ecosystems	NNS	ecosystem
yields	VBZ	yield
better	JJR	good
protection	NN	protection
.	SENT	.
Despite	IN	despite
this	DT	this
,	,	,
Indigenous	JJ	indigenous
Peoples	NPS	Peoples
often	RB	often
face	VBP	face
displacement	NN	displacement
by	IN	by
industries	NNS	industry
.	SENT	.
While	IN	while
there	EX	there
has	VBZ	have
been	VBN	be
some	DT	some
progress	NN	progress
in	IN	in
places	NNS	place
like	IN	like
the	DT	the
Democratic	NP	Democratic
Republic	NP	Republic
of	IN	of
Congo	NP	Congo
,	,	,
much	RB	much
more	JJR	more
investment	NN	investment
is	VBZ	be
needed	VBN	need
.	SENT	.
At	IN	at
the	DT	the
Montreal	NP	Montreal
summit	NN	summit
,	,	,
we	PP	we
must	MD	must
reject	VB	reject
exclusionary	JJ	exclusionary
models	NNS	model
and	CC	and
fully	RB	fully
embrace	VB	embrace
a	DT	a
just	JJ	just
conservation	NN	conservation
framework	NN	framework
that	WDT	that
empowers	VBZ	empower
Indigenous	JJ	indigenous
communities	NNS	community
.	SENT	.
