In	IN	in
the	DT	the
Caititu	NP	<unknown>
Indigenous	JJ	indigenous
Land	NP	Land
,	,	,
Chief	NP	Chief
Puraka	NP	<unknown>
and	CC	and
the	DT	the
Apurinã	NP	<unknown>
people	NNS	people
value	NN	value
living	NN	living
in	IN	in
harmony	NN	harmony
with	IN	with
nature	NN	nature
.	SENT	.
This	DT	this
way	NN	way
of	IN	of
life	NN	life
is	VBZ	be
under	IN	under
threat	NN	threat
from	IN	from
deforestation	NN	deforestation
driven	VBN	drive
by	IN	by
agribusiness	NN	agribusiness
,	,	,
an	DT	an
industry	NN	industry
that	WDT	that
consumes	VBZ	consume
70	CD	@card@
%	NN	%
of	IN	of
the	DT	the
world	NN	world
's	POS	's
freshwater	NN	freshwater
and	CC	and
exacerbates	VBZ	exacerbate
water	NN	water
crises	NNS	crisis
and	CC	and
extreme	JJ	extreme
weather	NN	weather
events	NNS	event
.	SENT	.
This	DT	this
model	NN	model
of	IN	of
destruction-based	JJ	<unknown>
economics	NNS	economics
disproportionately	RB	disproportionately
harms	VBZ	harm
low-income	JJ	low-income
communities	NNS	community
.	SENT	.
In	IN	in
deforested	VBN	deforest
areas	NNS	area
such	JJ	such
as	IN	as
the	DT	the
state	NN	state
of	IN	of
Pará	NP	<unknown>
,	,	,
the	DT	the
Human	NP	Human
Development	NP	Development
Index	NP	Index
(	(	(
HDI	NP	HDI
)	)	)
is	VBZ	be
low	JJ	low
.	SENT	.
The	DT	the
situation	NN	situation
is	VBZ	be
worsened	VBN	worsen
by	IN	by
pending	VBG	pend
bills	NNS	bill
in	IN	in
the	DT	the
legislature	NN	legislature
that	IN	that
risk	NN	risk
legalizing	VBG	legalize
land	NN	land
invasions	NNS	invasion
and	CC	and
undermining	VBG	undermine
the	DT	the
rights	NNS	right
of	IN	of
indigenous	JJ	indigenous
peoples	NNS	people
.	SENT	.
There	EX	there
are	VBP	be
,	,	,
however	RB	however
,	,	,
viable	JJ	viable
alternatives	NNS	alternative
.	SENT	.
These	DT	these
include	VBP	include
socio-biodiversity	NN	socio-biodiversity
chains	NNS	chain
,	,	,
such	JJ	such
as	IN	as
managed	JJ	managed
fishing	NN	fishing
and	CC	and
the	DT	the
collection	NN	collection
of	IN	of
nuts	NNS	nut
,	,	,
as	RB	as
well	RB	well
as	IN	as
agroforestry	NN	agroforestry
systems	NNS	system
that	WDT	that
revive	VBP	revive
traditional	JJ	traditional
practices	NNS	practice
.	SENT	.
Family	NN	family
farming	NN	farming
also	RB	also
presents	VBZ	present
a	DT	a
path	NN	path
toward	IN	toward
more	JJR	more
inclusive	JJ	inclusive
production	NN	production
.	SENT	.
The	DT	the
consequences	NNS	consequence
of	IN	of
failing	VBG	fail
to	TO	to
adopt	VB	adopt
these	DT	these
alternatives	NNS	alternative
are	VBP	be
widespread	JJ	widespread
,	,	,
as	IN	as
reduced	VBN	reduce
evaporation	NN	evaporation
from	IN	from
the	DT	the
Amazon	NP	Amazon
rainforest	NN	rainforest
is	VBZ	be
already	RB	already
contributing	VBG	contribute
to	TO	to
droughts	NNS	drought
across	IN	across
the	DT	the
continent	NN	continent
.	SENT	.
