September	NP	September
2021	NP	@card@
marks	VBZ	mark
fifty	CD	fifty
years	NNS	year
since	IN	since
our	PP$	our
first	JJ	first
campaign	NN	campaign
:	:	:
a	DT	a
protest	NN	protest
against	IN	against
a	DT	a
U.S.	NP	U.S.
nuclear	JJ	nuclear
bomb	NN	bomb
test	NN	test
scheduled	VBN	schedule
for	IN	for
Amchitka	NP	<unknown>
,	,	,
Alaska	NP	Alaska
.	SENT	.
Our	PP$	our
origins	NNS	origin
can	MD	can
be	VB	be
found	VBN	find
in	IN	in
1960s	NNS	1960s
Vancouver	NP	Vancouver
,	,	,
a	DT	a
city	NN	city
that	WDT	that
became	VBD	become
a	DT	a
convergence	NN	convergence
point	NN	point
for	IN	for
peace	NN	peace
activists	NNS	activist
,	,	,
ecologists	NNS	ecologist
,	,	,
and	CC	and
draft	NN	draft
resisters	NNS	resister
.	SENT	.
In	IN	in
this	DT	this
environment	NN	environment
,	,	,
shaped	VBN	shape
by	IN	by
anti-war	JJ	anti-war
,	,	,
civil	JJ	civil
rights	NNS	right
,	,	,
and	CC	and
environmental	JJ	environmental
movements	NNS	movement
,	,	,
a	DT	a
group	NN	group
of	IN	of
individuals	NNS	individual
came	VBD	come
together	RB	together
.	SENT	.
Among	IN	among
them	PP	them
were	VBD	be
Irving	NP	Irving
and	CC	and
Dorothy	NP	Dorothy
Stowe	NP	Stowe
,	,	,
Bob	NP	Bob
Hunter	NP	Hunter
,	,	,
Ben	NP	Ben
and	CC	and
Dorothy	NP	Dorothy
Metcalfe	NP	Metcalfe
,	,	,
Jim	NP	Jim
and	CC	and
Marie	NP	Marie
Bohlen	NP	Bohlen
,	,	,
and	CC	and
Bill	NP	Bill
Darnell	NP	Darnell
.	SENT	.
They	PP	they
formed	VBD	form
the	DT	the
Do	VBP	do
nâ€™t	RB	n't
Make	VB	make
a	DT	a
Wave	NP	Wave
Committee	NP	Committee
.	SENT	.
Drawing	VBG	draw
inspiration	NN	inspiration
from	IN	from
Quaker	JJ	Quaker
protests	NNS	protest
,	,	,
their	PP$	their
plan	NN	plan
was	VBD	be
to	TO	to
sail	VB	sail
a	DT	a
boat	NN	boat
to	TO	to
confront	VB	confront
the	DT	the
nuclear	JJ	nuclear
test	NN	test
directly	RB	directly
.	SENT	.
It	PP	it
was	VBD	be
from	IN	from
this	DT	this
core	JJ	core
idea	NN	idea
that	IN	that
a	DT	a
new	JJ	new
name	NN	name
was	VBD	be
adopted	VBN	adopt
,	,	,
one	CD	one
that	WDT	that
merged	VBD	merge
the	DT	the
ideals	NNS	ideal
of	IN	of
peace	NN	peace
and	CC	and
ecology	NN	ecology
:	:	:
Greenpeace	NP	Greenpeace
.	SENT	.
