Dorothy	NP	Dorothy
Stowe	NP	Stowe
,	,	,
who	WP	who
would	MD	would
be	VB	be
100	CD	@card@
today	NN	today
,	,	,
co-founded	VBD	co-found
Greenpeace	NP	Greenpeace
in	IN	in
Vancouver	NP	Vancouver
with	IN	with
her	PP$	her
husband	NN	husband
Irving	NP	Irving
and	CC	and
other	JJ	other
pacifists	NNS	pacifist
and	CC	and
ecologists	NNS	ecologist
.	SENT	.
She	PP	she
passed	VBD	pass
away	RB	away
ten	CD	ten
years	NNS	year
ago	RB	ago
in	IN	in
the	DT	the
same	JJ	same
city	NN	city
.	SENT	.
A	DT	a
2009	CD	@card@
photo	NN	photo
captures	VBZ	capture
her	PP	her
at	IN	at
a	DT	a
CD	NN	CD
release	NN	release
party	NN	party
for	IN	for
the	DT	the
1970	CD	@card@
concert	NN	concert
that	WDT	that
launched	VBD	launch
Greenpeace	NP	Greenpeace
,	,	,
which	WDT	which
featured	VBD	feature
Joni	NP	Joni
Mitchell	NP	Mitchell
and	CC	and
James	NP	James
Taylor	NP	Taylor
.	SENT	.
She	PP	she
exemplified	VBD	exemplify
unwavering	VBG	unwaver
dedication	NN	dedication
,	,	,
modesty	NN	modesty
,	,	,
and	CC	and
kindness	NN	kindness
.	SENT	.
Her	PP$	her
activism	NN	activism
was	VBD	be
focused	VBN	focus
on	IN	on
issues	NNS	issue
rather	RB	rather
than	IN	than
herself	PP	herself
,	,	,
and	CC	and
she	PP	she
was	VBD	be
known	VBN	know
for	IN	for
volunteering	VBG	volunteer
for	IN	for
any	DT	any
task	NN	task
.	SENT	.
She	PP	she
remained	VBD	remain
unintimidated	JJ	unintimidated
,	,	,
even	RB	even
by	IN	by
figures	NNS	figure
like	IN	like
Canada	NP	Canada
's	POS	's
Prime	NP	Prime
Minister	NP	Minister
.	SENT	.
Dorothy	NP	Dorothy
and	CC	and
Irving	NP	Irving
held	VBD	hold
their	PP$	their
wedding	NN	wedding
at	IN	at
NAACP	NP	NAACP
headquarters	NN	headquarters
.	SENT	.
They	PP	they
became	VBD	become
Quakers	NNS	Quaker
dedicated	VBN	dedicate
to	TO	to
peace	NN	peace
and	CC	and
justice	NN	justice
and	CC	and
adopted	VBD	adopt
the	DT	the
name	NN	name
"	``	"
Stowe	NP	Stowe
"	''	"
from	IN	from
Harriet	NP	Harriet
Beecher	NP	Beecher
Stowe	NP	Stowe
.	SENT	.
In	IN	in
Greenpeace	NP	Greenpeace
's	POS	's
early	JJ	early
years	NNS	year
,	,	,
they	PP	they
provided	VBD	provide
a	DT	a
stabilizing	VBG	stabilize
and	CC	and
inclusive	JJ	inclusive
influence	NN	influence
,	,	,
inspiring	JJ	inspiring
others	NNS	other
through	IN	through
hard	JJ	hard
work	NN	work
and	CC	and
heart	NN	heart
.	SENT	.
