While	IN	while
World	NP	World
Fisheries	NNS	fishery
Day	NP	Day
on	IN	on
November	NP	November
21	CD	@card@
is	VBZ	be
an	DT	an
occasion	NN	occasion
to	TO	to
celebrate	VB	celebrate
sustainable	JJ	sustainable
small	JJ	small
fisheries	NNS	fishery
,	,	,
it	PP	it
also	RB	also
exposes	VBZ	expose
the	DT	the
severe	JJ	severe
human	JJ	human
rights	NNS	right
abuses	NNS	abuse
that	WDT	that
plague	VBP	plague
industrial	JJ	industrial
distant	JJ	distant
water	NN	water
fisheries	NNS	fishery
(	(	(
DWF	NP	DWF
)	)	)
.	SENT	.
These	DT	these
operations	NNS	operation
are	VBP	be
often	RB	often
driven	VBN	drive
by	IN	by
greedy	JJ	greedy
corporations	NNS	corporation
.	SENT	.
As	IN	as
fish	NN	fish
stocks	NNS	stock
decline	NN	decline
,	,	,
vessels	NNS	vessel
are	VBP	be
forced	VBN	force
to	TO	to
travel	VB	travel
farther	RBR	farther
from	IN	from
shore	VB	shore
.	SENT	.
To	TO	to
cut	VB	cut
costs	NNS	cost
on	IN	on
these	DT	these
long	JJ	long
voyages	NNS	voyage
,	,	,
there	EX	there
is	VBZ	be
widespread	JJ	widespread
exploitation	NN	exploitation
of	IN	of
migrant	JJ	migrant
workers	NNS	worker
,	,	,
including	VBG	include
forced	VBN	force
labor	NN	labor
.	SENT	.
This	DT	this
tainted	JJ	tainted
seafood	NN	seafood
then	RB	then
reaches	VBZ	reach
global	JJ	global
markets	NNS	market
,	,	,
a	DT	a
consequence	NN	consequence
of	IN	of
buyers	NNS	buyer
failing	VBG	fail
to	TO	to
perform	VB	perform
adequate	JJ	adequate
due	JJ	due
diligence	NN	diligence
in	IN	in
their	PP$	their
supply	NN	supply
chains	NNS	chain
.	SENT	.
Greenpeace	NP	Greenpeace
has	VBZ	have
linked	VBN	link
the	DT	the
Taiwanese	JJ	Taiwanese
firm	NN	firm
FCF	NN	FCF
to	TO	to
instances	NNS	instance
of	IN	of
forced	VBN	force
labor	NN	labor
and	CC	and
illegal	JJ	illegal
fishing	NN	fishing
.	SENT	.
The	DT	the
problem	NN	problem
is	VBZ	be
significant	JJ	significant
enough	RB	enough
that	IN	that
the	DT	the
US	NP	US
Department	NP	Department
of	IN	of
Labor	NP	Labor
has	VBZ	have
listed	VBN	list
Taiwan	NP	Taiwan
for	IN	for
its	PP$	its
use	NN	use
of	IN	of
such	JJ	such
practices	NNS	practice
.	SENT	.
To	TO	to
fix	VB	fix
this	DT	this
,	,	,
governments	NNS	government
must	MD	must
enforce	VB	enforce
protections	NNS	protection
for	IN	for
workers	NNS	worker
at	IN	at
sea	NN	sea
.	SENT	.
Consumers	NNS	consumer
can	MD	can
also	RB	also
contribute	VB	contribute
to	TO	to
creating	VBG	create
a	DT	a
better	JJR	good
industry	NN	industry
by	IN	by
reducing	VBG	reduce
their	PP$	their
seafood	NN	seafood
consumption	NN	consumption
and	CC	and
choosing	VBG	choose
to	TO	to
support	VB	support
local	JJ	local
,	,	,
sustainable	JJ	sustainable
options	NNS	option
.	SENT	.
