From	IN	from
his	PP$	his
suburban	JJ	suburban
apartment	NN	apartment
,	,	,
Julien	NP	Julien
Jreissati	NP	<unknown>
experienced	VBD	experience
the	DT	the
Beirut	NP	Beirut
port	NN	port
explosion	NN	explosion
.	SENT	.
The	DT	the
blast	NN	blast
was	VBD	be
caused	VBN	cause
by	IN	by
2,750	CD	@card@
tons	NNS	ton
of	IN	of
ammonium	NN	ammonium
nitrate	NN	nitrate
igniting	VBG	ignite
,	,	,
which	WDT	which
led	VBD	lead
to	TO	to
over	RB	over
150	CD	@card@
deaths	NNS	death
,	,	,
5,000	CD	@card@
injuries	NNS	injury
,	,	,
and	CC	and
widespread	JJ	widespread
destruction	NN	destruction
.	SENT	.
After	IN	after
checking	NN	checking
on	IN	on
his	PP$	his
loved	VBN	love
ones	NNS	one
,	,	,
Jreissati	NP	<unknown>
formed	VBD	form
a	DT	a
Greenpeace	NP	Greenpeace
MENA	NP	Mena
crisis	NN	crisis
team	NN	team
.	SENT	.
Their	PP$	their
initial	JJ	initial
priority	NN	priority
was	VBD	be
to	TO	to
ensure	VB	ensure
the	DT	the
safety	NN	safety
of	IN	of
their	PP$	their
staff	NN	staff
.	SENT	.
The	DT	the
team	NN	team
also	RB	also
consulted	VBN	consult
experts	NNS	expert
to	TO	to
assess	VB	assess
the	DT	the
health	NN	health
risks	NNS	risk
from	IN	from
the	DT	the
resulting	VBG	result
nitrogen	NN	nitrogen
dioxide	NN	dioxide
and	CC	and
ozone	NN	ozone
pollution	NN	pollution
.	SENT	.
In	IN	in
the	DT	the
context	NN	context
of	IN	of
the	DT	the
ongoing	JJ	ongoing
COVID-19	NP	<unknown>
pandemic	NN	pandemic
,	,	,
they	PP	they
developed	VBD	develop
safety	NN	safety
guidelines	NNS	guideline
for	IN	for
the	DT	the
public	NN	public
.	SENT	.
Greenpeace	NP	Greenpeace
MENA	NP	Mena
is	VBZ	be
currently	RB	currently
using	VBG	use
satellite	JJ	satellite
imagery	NN	imagery
to	TO	to
investigate	VB	investigate
for	IN	for
additional	JJ	additional
pollutants	NNS	pollutant
.	SENT	.
As	IN	as
Lebanese	JJ	Lebanese
solidarity	NN	solidarity
aids	NNS	aid
in	IN	in
the	DT	the
recovery	NN	recovery
efforts	NNS	effort
,	,	,
Greenpeace	NP	Greenpeace
is	VBZ	be
providing	VBG	provide
information	NN	information
on	IN	on
how	WRB	how
to	TO	to
deal	VB	deal
with	IN	with
toxic	JJ	toxic
dust	NN	dust
.	SENT	.
The	DT	the
organization	NN	organization
is	VBZ	be
also	RB	also
calling	VBG	call
for	IN	for
people	NNS	people
to	TO	to
make	VB	make
donations	NNS	donation
to	TO	to
the	DT	the
Red	NP	Red
Cross	NP	Cross
.	SENT	.
