In	IN	in
2019	CD	@card@
,	,	,
global	JJ	global
military	JJ	military
spending	NN	spending
reached	VBN	reach
$1.9	NP	<unknown>
trillion	CD	trillion
,	,	,
marking	VBG	mark
a	DT	a
3.6	CD	@card@
%	NN	%
increase	NN	increase
.	SENT	.
This	DT	this
spending	NN	spending
continued	VBD	continue
to	TO	to
rise	VB	rise
in	IN	in
2020	CD	@card@
,	,	,
with	IN	with
the	DT	the
United	NP	United
States	NPS	States
increasing	VBG	increase
its	PP$	its
budget	NN	budget
by	IN	by
5.3	CD	@card@
%	NN	%
and	CC	and
Germany	NP	Germany
by	IN	by
10	CD	@card@
%	NN	%
.	SENT	.
These	DT	these
costs	NNS	cost
stand	VBP	stand
in	IN	in
stark	JJ	stark
contrast	NN	contrast
to	TO	to
healthcare	NN	<unknown>
needs	NNS	need
.	SENT	.
The	DT	the
price	NN	price
of	IN	of
a	DT	a
single	JJ	single
Leopard	NP	Leopard
2	CD	@card@
tank	NN	tank
is	VBZ	be
equivalent	JJ	equivalent
to	TO	to
that	DT	that
of	IN	of
440	CD	@card@
ventilators	NNS	ventilator
.	SENT	.
Global	JJ	global
budgets	NNS	budget
for	IN	for
nuclear	JJ	nuclear
weapons	NNS	weapon
are	VBP	be
ten	CD	ten
times	NNS	time
the	DT	the
combined	JJ	combined
budgets	NNS	budget
of	IN	of
the	DT	the
United	NP	United
Nations	NPS	Nations
and	CC	and
the	DT	the
World	NP	World
Health	NP	Health
Organization	NP	Organization
.	SENT	.
The	DT	the
COVID-19	NP	<unknown>
pandemic	NN	pandemic
exposes	VBZ	expose
these	DT	these
misplaced	VBN	misplace
priorities	NNS	priority
.	SENT	.
There	EX	there
is	VBZ	be
an	DT	an
urgent	JJ	urgent
need	NN	need
to	TO	to
shift	VB	shift
focus	NN	focus
from	IN	from
militarism	NN	militarism
to	TO	to
funding	NN	funding
healthcare	NN	<unknown>
,	,	,
poverty	NN	poverty
reduction	NN	reduction
,	,	,
and	CC	and
environmental	JJ	environmental
protection	NN	protection
.	SENT	.
We	PP	we
must	MD	must
call	VB	call
for	IN	for
budgets	NNS	budget
to	TO	to
be	VB	be
reallocated	VBN	reallocate
and	CC	and
support	VB	support
a	DT	a
global	JJ	global
ceasefire	NN	ceasefire
.	SENT	.
Use	VB	use
the	DT	the
#movethemoney	NN	#movethemoney
and	CC	and
#Doves4Peace	NN	#Doves4peace
campaigns	NNS	campaign
to	TO	to
join	VB	join
this	DT	this
call	NN	call
.	SENT	.
