The	DT	the
impacts	NNS	impact
of	IN	of
COVID-19	NP	<unknown>
on	IN	on
daily	JJ	daily
life	NN	life
call	NN	call
for	IN	for
a	DT	a
focus	NN	focus
on	IN	on
systemic	JJ	systemic
solutions	NNS	solution
,	,	,
alongside	IN	alongside
the	DT	the
promotion	NN	promotion
of	IN	of
community	NN	community
care	NN	care
rooted	VBN	root
in	IN	in
love	NN	love
and	CC	and
compassion	NN	compassion
.	SENT	.
There	EX	there
are	VBP	be
eleven	NN	eleven
key	JJ	key
ways	NNS	way
to	TO	to
safely	RB	safely
support	VB	support
others	NNS	other
.	SENT	.
We	PP	we
can	MD	can
use	VB	use
alternatives	NNS	alternative
to	TO	to
social	JJ	social
distancing	NN	distancing
to	TO	to
stay	VB	stay
connected	JJ	connected
,	,	,
check	NN	check
on	IN	on
individuals	NNS	individual
who	WP	who
are	VBP	be
isolated	VBN	isolate
,	,	,
and	CC	and
offer	VB	offer
practical	JJ	practical
assistance	NN	assistance
like	IN	like
shopping	NN	shopping
deliveries	NNS	delivery
.	SENT	.
It	PP	it
is	VBZ	be
vital	JJ	vital
to	TO	to
combat	VB	combat
racism	NN	racism
against	IN	against
those	DT	those
of	IN	of
Chinese	JJ	Chinese
descent	NN	descent
and	CC	and
to	TO	to
appreciate	VB	appreciate
government	NN	government
financial	JJ	financial
aid	NN	aid
where	WRB	where
it	PP	it
is	VBZ	be
provided	VBN	provide
.	SENT	.
We	PP	we
can	MD	can
also	RB	also
help	VB	help
by	IN	by
countering	VBG	counter
misinformation	NN	misinformation
,	,	,
suggesting	VBG	suggest
that	IN	that
landlords	NNS	landlord
implement	VB	implement
rent	NN	rent
freezes	NNS	freeze
,	,	,
and	CC	and
fundraising	VBG	fundrais
for	IN	for
those	DT	those
affected	VBN	affect
by	IN	by
the	DT	the
crisis	NN	crisis
.	SENT	.
Hosting	VBG	host
virtual	JJ	virtual
celebrations	NNS	celebration
and	CC	and
sharing	VBG	share
positive	JJ	positive
stories	NNS	story
can	MD	can
help	VB	help
maintain	VB	maintain
morale	NN	morale
.	SENT	.
When	WRB	when
preparing	VBG	prepare
,	,	,
we	PP	we
should	MD	should
do	VB	do
so	RB	so
without	IN	without
hoarding	NN	hoarding
,	,	,
and	CC	and
remember	VB	remember
the	DT	the
importance	NN	importance
of	IN	of
frequent	JJ	frequent
handwashing	NN	handwashing
.	SENT	.
This	DT	this
crisis	NN	crisis
has	VBZ	have
exposed	VBN	expose
existing	JJ	existing
inequalities	NNS	inequality
.	SENT	.
As	IN	as
we	PP	we
move	VBP	move
forward	RB	forward
,	,	,
we	PP	we
must	MD	must
call	VB	call
against	IN	against
bailouts	NNS	bailout
for	IN	for
the	DT	the
fossil	JJ	fossil
fuel	NN	fuel
industry	NN	industry
.	SENT	.
Instead	RB	instead
,	,	,
we	PP	we
should	MD	should
advocate	VB	advocate
for	IN	for
a	DT	a
green	JJ	green
stimulus	NN	stimulus
aimed	VBN	aim
at	IN	at
building	VBG	build
a	DT	a
resilient	JJ	resilient
and	CC	and
caring	JJ	caring
society	NN	society
.	SENT	.
