A	DT	a
Greenpeace	NP	Greenpeace
East	NP	East
Asia	NP	Asia
report	NN	report
has	VBZ	have
exposed	VBN	expose
links	NNS	link
between	IN	between
Taiwanese	JJ	Taiwanese
seafood	NN	seafood
giant	NN	giant
Fong	NP	Fong
Chun	NP	Chun
Formosa	NP	Formosa
(	(	(
FCF	NP	FCF
)	)	)
and	CC	and
severe	JJ	severe
abuses	NNS	abuse
in	IN	in
the	DT	the
fishing	NN	fishing
industry	NN	industry
.	SENT	.
FCF	NP	FCF
,	,	,
a	DT	a
top	JJ	top
tuna	NN	tuna
trader	NN	trader
with	IN	with
an	DT	an
annual	JJ	annual
revenue	NN	revenue
of	IN	of
$45	JJ	$@card@
billion	NNS	billion
,	,	,
has	VBZ	have
been	VBN	be
connected	VBN	connect
to	TO	to
forced	VBN	force
labor	NN	labor
on	IN	on
migrant	JJ	migrant
workers	NNS	worker
,	,	,
illegal	JJ	illegal
fishing	NN	fishing
,	,	,
shark	NN	shark
finning	VBG	fin
,	,	,
and	CC	and
transshipment	NN	transshipment
at	IN	at
sea	NN	sea
.	SENT	.
The	DT	the
exploitation	NN	exploitation
is	VBZ	be
enabled	VBN	enable
by	IN	by
Taiwan	NP	Taiwan
's	POS	's
two-tiered	JJ	two-tiered
system	NN	system
,	,	,
which	WDT	which
excludes	VBZ	exclude
vulnerable	JJ	vulnerable
Southeast	JJ	southeast
Asian	JJ	Asian
fishers	NNS	fisher
from	IN	from
proper	JJ	proper
labor	NN	labor
protections	NNS	protection
.	SENT	.
We	PP	we
urge	VBP	urge
the	DT	the
Taiwanese	JJ	Taiwanese
government	NN	government
to	TO	to
abolish	VB	abolish
this	DT	this
system	NN	system
,	,	,
adopt	VB	adopt
International	NP	International
Labour	NP	Labour
Organization	NP	Organization
(	(	(
ILO	NP	Ilo
)	)	)
conventions	NNS	convention
,	,	,
enhance	VB	enhance
inspections	NNS	inspection
,	,	,
and	CC	and
create	VB	create
grievance	NN	grievance
mechanisms	NNS	mechanism
for	IN	for
workers	NNS	worker
.	SENT	.
We	PP	we
also	RB	also
call	VBP	call
on	IN	on
FCF	NP	FCF
to	TO	to
take	VB	take
immediate	JJ	immediate
action	NN	action
by	IN	by
disclosing	VBG	disclose
its	PP$	its
suppliers	NNS	supplier
,	,	,
ending	VBG	end
the	DT	the
practice	NN	practice
of	IN	of
transshipment	NN	transshipment
,	,	,
ensuring	VBG	ensure
adequate	JJ	adequate
monitoring	NN	monitoring
,	,	,
and	CC	and
upgrading	VBG	upgrade
its	PP$	its
human	JJ	human
rights	NNS	right
policies	NNS	policy
.	SENT	.
Consumers	NNS	consumer
can	MD	can
help	VB	help
combat	VB	combat
these	DT	these
industry	NN	industry
abuses	NNS	abuse
by	IN	by
reducing	VBG	reduce
their	PP$	their
seafood	NN	seafood
intake	NN	intake
and	CC	and
supporting	VBG	support
local	JJ	local
fisheries	NNS	fishery
.	SENT	.
