Governments	NNS	government
are	VBP	be
failing	VBG	fail
to	TO	to
meet	VB	meet
their	PP$	their
Paris	NP	Paris
Agreement	NP	Agreement
climate	NN	climate
promises	NNS	promise
,	,	,
a	DT	a
reality	NN	reality
that	WDT	that
is	VBZ	be
prompting	VBG	prompt
thousands	NNS	thousand
of	IN	of
people	NNS	people
to	TO	to
seek	VB	seek
justice	NN	justice
through	IN	through
the	DT	the
courts	NNS	court
.	SENT	.
In	IN	in
response	NN	response
,	,	,
the	DT	the
legal	JJ	legal
profession	NN	profession
is	VBZ	be
mobilizing	VBG	mobilize
.	SENT	.
The	DT	the
International	NP	International
Bar	NP	Bar
Association	NP	Association
has	VBZ	have
created	VBN	create
a	DT	a
Model	NP	Model
Statute	NP	Statute
to	TO	to
aid	VB	aid
judges	NNS	judge
and	CC	and
lawyers	NNS	lawyer
in	IN	in
assessing	VBG	assess
evidence	NN	evidence
and	CC	and
enforcing	VBG	enforce
the	DT	the
rights	NNS	right
of	IN	of
people	NNS	people
to	TO	to
challenge	VB	challenge
governments	NNS	government
and	CC	and
corporations	NNS	corporation
.	SENT	.
Greenpeace	NP	Greenpeace
Southeast	NP	Southeast
Asia	NP	Asia
is	VBZ	be
also	RB	also
contributing	VBG	contribute
by	IN	by
offering	VBG	offer
a	DT	a
guide	NN	guide
for	IN	for
public	JJ	public
accountability	NN	accountability
.	SENT	.
Globally	RB	globally
,	,	,
over	IN	over
600	CD	@card@
climate-related	JJ	climate-related
cases	NNS	case
have	VBP	have
been	VBN	be
filed	VBN	file
.	SENT	.
Notable	JJ	notable
examples	NNS	example
include	VBP	include
Urgenda	NP	<unknown>
's	POS	's
victory	NN	victory
in	IN	in
the	DT	the
Dutch	JJ	Dutch
Supreme	NP	Supreme
Court	NP	Court
and	CC	and
the	DT	the
Klimaseniorinnen	NP	<unknown>
appeal	NN	appeal
in	IN	in
Switzerland	NP	Switzerland
.	SENT	.
In	IN	in
Norway	NP	Norway
,	,	,
a	DT	a
youth-led	JJ	<unknown>
constitutional	JJ	constitutional
challenge	NN	challenge
is	VBZ	be
underway	JJ	underway
.	SENT	.
This	DT	this
movement	NN	movement
for	IN	for
legal	JJ	legal
accountability	NN	accountability
is	VBZ	be
further	RBR	further
supported	VBN	support
by	IN	by
a	DT	a
Peoples	NPS	Peoples
â€™	POS	'
Summit	NP	Summit
declaration	NN	declaration
which	WDT	which
demands	VBZ	demand
access	NN	access
to	TO	to
justice	NN	justice
.	SENT	.
The	DT	the
fight	NN	fight
extends	VBZ	extend
to	TO	to
the	DT	the
corporate	JJ	corporate
world	NN	world
,	,	,
as	RB	as
seen	VBN	see
in	IN	in
the	DT	the
Philippines	NPS	Philippine
,	,	,
where	WRB	where
companies	NNS	company
like	IN	like
Exxon	NP	Exxon
are	VBP	be
being	VBG	be
held	VBN	hold
liable	JJ	liable
for	IN	for
climate	NN	climate
impacts	NNS	impact
.	SENT	.
