In	IN	in
the	DT	the
fishing	NN	fishing
industry	NN	industry
,	,	,
modern	JJ	modern
slavery	NN	slavery
is	VBZ	be
a	DT	a
harsh	JJ	harsh
reality	NN	reality
,	,	,
particularly	RB	particularly
for	IN	for
migrant	JJ	migrant
workers	NNS	worker
from	IN	from
Indonesia	NP	Indonesia
and	CC	and
the	DT	the
Philippines	NPS	Philippine
.	SENT	.
Media	NP	Media
has	VBZ	have
exposed	VBN	expose
the	DT	the
inhumane	JJ	inhumane
conditions	NNS	condition
these	DT	these
workers	NNS	worker
face	VBP	face
.	SENT	.
A	DT	a
key	JJ	key
practice	NN	practice
enabling	VBG	enable
this	DT	this
exploitation	NN	exploitation
is	VBZ	be
transshipment	NN	transshipment
,	,	,
which	WDT	which
allows	VBZ	allow
vessels	NNS	vessel
to	TO	to
remain	VB	remain
at	IN	at
sea	NN	sea
for	IN	for
prolonged	JJ	prolonged
periods	NNS	period
.	SENT	.
This	DT	this
isolation	NN	isolation
facilitates	VBZ	facilitate
forced	VBN	force
labor	NN	labor
and	CC	and
exploitation	NN	exploitation
,	,	,
while	IN	while
governments	NNS	government
are	VBP	be
criticized	VBN	criticize
for	IN	for
their	PP$	their
failure	NN	failure
to	TO	to
protect	VB	protect
these	DT	these
vulnerable	JJ	vulnerable
workers	NNS	worker
.	SENT	.
Greenpeace	NP	Greenpeace
Southeast	NP	Southeast
Asia	NP	Asia
's	POS	's
report	NN	report
,	,	,
“	``	"
Seabound	JJ	Seabound
:	:	:
The	DT	the
Journey	NP	Journey
to	TO	to
Modern	NP	Modern
Slavery	NN	slavery
on	IN	on
the	DT	the
High	JJ	high
Seas	NNS	sea
,	,	,
”	''	"
sheds	VBZ	shed
light	NN	light
on	IN	on
this	DT	this
crisis	NN	crisis
through	IN	through
the	DT	the
direct	JJ	direct
testimonials	NNS	testimonial
of	IN	of
fishers	NNS	fisher
.	SENT	.
Their	PP$	their
stories	NNS	story
reveal	VBP	reveal
a	DT	a
pattern	NN	pattern
of	IN	of
deceptive	JJ	deceptive
recruitment	NN	recruitment
agencies	NNS	agency
and	CC	and
the	DT	the
economic	JJ	economic
desperation	NN	desperation
that	WDT	that
drives	VBZ	drive
them	PP	them
to	TO	to
seek	VB	seek
this	DT	this
work	NN	work
.	SENT	.
Many	JJ	many
face	NN	face
language	NN	language
barriers	NNS	barrier
,	,	,
signing	VBG	sign
contracts	NNS	contract
they	PP	they
cannot	MD	can
understand	VB	understand
.	SENT	.
The	DT	the
report	NN	report
also	RB	also
highlights	VBZ	highlight
how	WRB	how
overfishing	NN	overfishing
has	VBZ	have
pushed	VBN	push
fleets	NNS	fleet
into	IN	into
distant	JJ	distant
water	NN	water
fishing	NN	fishing
,	,	,
exacerbating	VBG	exacerbate
these	DT	these
exploitative	JJ	exploitative
conditions	NNS	condition
.	SENT	.
On	IN	on
Human	NP	Human
Rights	NPS	Rights
Day	NP	Day
,	,	,
there	EX	there
is	VBZ	be
an	DT	an
urgent	JJ	urgent
call	NN	call
for	IN	for
ASEAN	NP	ASEAN
states	NNS	state
to	TO	to
take	VB	take
action	NN	action
.	SENT	.
They	PP	they
must	MD	must
enforce	VB	enforce
existing	VBG	exist
laws	NNS	law
,	,	,
address	VB	address
the	DT	the
discrimination	NN	discrimination
faced	VBN	face
by	IN	by
migrant	JJ	migrant
fishers	NNS	fisher
,	,	,
and	CC	and
actively	RB	actively
promote	VB	promote
ethical	JJ	ethical
practices	NNS	practice
throughout	IN	throughout
the	DT	the
industry	NN	industry
.	SENT	.
