After	IN	after
eight	CD	eight
years	NNS	year
of	IN	of
public	JJ	public
pressure	NN	pressure
,	,	,
European	JJ	European
tuna	NN	tuna
giant	NN	giant
Bolton	NP	Bolton
has	VBZ	have
adopted	VBN	adopt
a	DT	a
progressive	JJ	progressive
sourcing	VBG	source
policy	NN	policy
.	SENT	.
The	DT	the
company	NN	company
,	,	,
once	RB	once
a	DT	a
laggard	NN	laggard
in	IN	in
2011	CD	@card@
,	,	,
has	VBZ	have
now	RB	now
committed	VBN	commit
that	IN	that
50	CD	@card@
%	NN	%
of	IN	of
its	PP$	its
tuna	NN	tuna
will	MD	will
be	VB	be
sourced	VBN	<unknown>
using	VBG	use
selective	JJ	selective
methods	NNS	method
like	IN	like
pole	NN	pole
and	CC	and
line	NN	line
or	CC	or
FAD-free	JJ	<unknown>
purse	NN	purse
seining	VBG	seine
,	,	,
an	DT	an
increase	NN	increase
of	IN	of
22	CD	@card@
%	NN	%
.	SENT	.
As	IN	as
part	NN	part
of	IN	of
its	PP$	its
new	JJ	new
policy	NN	policy
,	,	,
Bolton	NP	Bolton
will	MD	will
cap	VB	cap
the	DT	the
number	NN	number
of	IN	of
Fish	NP	Fish
Aggregating	VBG	aggregate
Devices	NPS	Devices
(	(	(
FADs	NNS	fad
)	)	)
at	IN	at
300	CD	@card@
,	,	,
prohibit	VB	prohibit
supply	NN	supply
vessels	NNS	vessel
,	,	,
and	CC	and
work	VBP	work
to	TO	to
reduce	VB	reduce
bycatch	NN	bycatch
.	SENT	.
This	DT	this
development	NN	development
follows	VBZ	follow
the	DT	the
landmark	JJ	landmark
commitments	NNS	commitment
made	VBN	make
by	IN	by
Thai	NP	Thai
Union	NP	Union
last	JJ	last
year	NN	year
,	,	,
which	WDT	which
came	VBD	come
in	IN	in
the	DT	the
midst	NN	midst
of	IN	of
Greenpeace	NP	Greenpeace
campaigns	NNS	campaign
addressing	VBG	address
the	DT	the
problems	NNS	problem
of	IN	of
overfishing	NN	overfishing
,	,	,
bycatch	NN	bycatch
,	,	,
and	CC	and
labor	NN	labor
abuses	NNS	abuse
in	IN	in
the	DT	the
industry	NN	industry
.	SENT	.
These	DT	these
changes	NNS	change
signal	VBP	signal
a	DT	a
growing	VBG	grow
momentum	NN	momentum
within	IN	within
the	DT	the
industry	NN	industry
for	IN	for
the	DT	the
protection	NN	protection
of	IN	of
our	PP$	our
oceans	NNS	ocean
and	CC	and
workers	NNS	worker
.	SENT	.
This	DT	this
move	NN	move
urges	VBZ	urge
other	JJ	other
companies	NNS	company
to	TO	to
improve	VB	improve
their	PP$	their
own	JJ	own
practices	NNS	practice
and	CC	and
highlights	VBZ	highlight
the	DT	the
impact	NN	impact
that	IN	that
individual	JJ	individual
actions	NNS	action
can	MD	can
have	VB	have
.	SENT	.
As	IN	as
we	PP	we
continue	VBP	continue
our	PP$	our
work	NN	work
,	,	,
Greenpeace	NP	Greenpeace
calls	VBZ	call
for	IN	for
the	DT	the
creation	NN	creation
of	IN	of
an	DT	an
Antarctic	JJ	Antarctic
ocean	NN	ocean
sanctuary	NN	sanctuary
.	SENT	.
