The	DT	the
first	JJ	first
round	NN	round
of	IN	of
UN	NP	UN
negotiations	NNS	negotiation
for	IN	for
a	DT	a
Global	NP	Global
Ocean	NP	Ocean
Treaty	NP	Treaty
has	VBZ	have
just	RB	just
concluded	VBN	conclude
.	SENT	.
These	DT	these
talks	NNS	talk
are	VBP	be
about	RB	about
the	DT	the
future	NN	future
of	IN	of
the	DT	the
high	JJ	high
seas	NNS	sea
,	,	,
vast	JJ	vast
ocean	NN	ocean
areas	NNS	area
that	WDT	that
cover	VBP	cover
nearly	RB	nearly
half	JJ	half
of	IN	of
our	PP$	our
planet	NN	planet
.	SENT	.
These	DT	these
oceans	NNS	ocean
face	VBP	face
immense	JJ	immense
threats	NNS	threat
from	IN	from
industrial	JJ	industrial
fishing	NN	fishing
,	,	,
pollution	NN	pollution
,	,	,
and	CC	and
the	DT	the
impacts	NNS	impact
of	IN	of
climate	NN	climate
change	NN	change
.	SENT	.
A	DT	a
strong	JJ	strong
treaty	NN	treaty
must	MD	must
be	VB	be
finalised	VBN	finalise
by	IN	by
2020	CD	@card@
.	SENT	.
This	DT	this
is	VBZ	be
essential	JJ	essential
to	TO	to
enable	VB	enable
the	DT	the
creation	NN	creation
of	IN	of
a	DT	a
network	NN	network
of	IN	of
ocean	NN	ocean
sanctuaries	NNS	sanctuary
.	SENT	.
As	IN	as
these	DT	these
negotiations	NNS	negotiation
continue	VBP	continue
,	,	,
Greenpeace	NP	Greenpeace
is	VBZ	be
campaigning	VBG	campaign
against	IN	against
the	DT	the
influence	NN	influence
of	IN	of
industry	NN	industry
lobbying	VBG	lobby
and	CC	and
urging	VBG	urge
for	IN	for
public	JJ	public
involvement	NN	involvement
to	TO	to
secure	VB	secure
a	DT	a
robust	JJ	robust
agreement	NN	agreement
.	SENT	.
We	PP	we
have	VBP	have
been	VBN	be
taking	VBG	take
action	NN	action
,	,	,
with	IN	with
protests	NNS	protest
using	VBG	use
banners	NNS	banner
and	CC	and
inflatable	NN	inflatable
turtles	NNS	turtle
,	,	,
and	CC	and
by	IN	by
delivering	VBG	deliver
origami	NN	origami
to	TO	to
delegates	NNS	delegate
.	SENT	.
While	IN	while
some	DT	some
nations	NNS	nation
are	VBP	be
pushing	VBG	push
for	IN	for
an	DT	an
ambitious	JJ	ambitious
treaty	NN	treaty
,	,	,
others	NNS	other
are	VBP	be
lagging	VBG	lag
behind	RB	behind
.	SENT	.
An	DT	an
upcoming	JJ	upcoming
opportunity	NN	opportunity
exists	VBZ	exist
to	TO	to
create	VB	create
an	DT	an
Antarctic	JJ	Antarctic
Ocean	NP	Ocean
Sanctuary	NN	sanctuary
,	,	,
a	DT	a
proposal	NN	proposal
already	RB	already
backed	VBN	back
by	IN	by
a	DT	a
movement	NN	movement
of	IN	of
nearly	RB	nearly
2	CD	@card@
million	CD	million
people	NNS	people
.	SENT	.
