In	IN	in
an	DT	an
interview	NN	interview
with	IN	with
vegan	NN	vegan
dietitian	NN	dietitian
Heather	NP	Heather
Russell	NP	Russell
from	IN	from
The	DT	the
Vegan	NN	vegan
Society	NP	Society
,	,	,
we	PP	we
discussed	VBD	discuss
the	DT	the
increasing	VBG	increase
popularity	NN	popularity
of	IN	of
vegan	NN	vegan
cafes	NNS	cafe
and	CC	and
the	DT	the
surprises	NNS	surprise
one	PP	one
can	MD	can
find	VB	find
in	IN	in
plant-based	JJ	<unknown>
meals	NNS	meal
.	SENT	.
Russell	NP	Russell
emphasized	VBD	emphasize
the	DT	the
importance	NN	importance
of	IN	of
balanced	JJ	balanced
nutrition	NN	nutrition
,	,	,
advising	VBG	advise
a	DT	a
focus	NN	focus
on	IN	on
whole	JJ	whole
grains	NNS	grain
,	,	,
nuts	NNS	nut
,	,	,
fruits	NNS	fruit
,	,	,
vegetables	NNS	vegetable
,	,	,
and	CC	and
legumes	NNS	legume
to	TO	to
avoid	VB	avoid
the	DT	the
pitfalls	NNS	pitfall
of	IN	of
high-fat	JJ	high-fat
,	,	,
sugary	JJ	sugary
vegan	NN	vegan
junk	NN	junk
food	NN	food
.	SENT	.
For	IN	for
those	DT	those
following	VBG	follow
a	DT	a
vegan	NN	vegan
diet	NN	diet
,	,	,
she	PP	she
noted	VBD	note
that	IN	that
essential	JJ	essential
supplements	NNS	supplement
include	VBP	include
vitamin	NN	vitamin
B12	NP	B@card@
,	,	,
vitamin	NN	vitamin
D	NP	D
,	,	,
iodine	NN	iodine
,	,	,
and	CC	and
selenium	NN	selenium
.	SENT	.
She	PP	she
also	RB	also
addressed	VBD	address
the	DT	the
accessibility	NN	accessibility
of	IN	of
veganism	NN	<unknown>
,	,	,
stating	VBG	state
that	IN	that
it	PP	it
can	MD	can
be	VB	be
both	DT	both
affordable	JJ	affordable
and	CC	and
culturally	RB	culturally
adaptable	JJ	adaptable
.	SENT	.
When	WRB	when
considering	VBG	consider
sustainable	JJ	sustainable
choices	NNS	choice
,	,	,
Russell	NP	Russell
promotes	VBZ	promote
eating	VBG	eat
seasonal	JJ	seasonal
produce	NN	produce
.	SENT	.
She	PP	she
also	RB	also
offered	VBD	offer
a	DT	a
critique	NN	critique
of	IN	of
lab-grown	JJ	lab-grown
meat	NN	meat
,	,	,
specifically	RB	specifically
if	IN	if
its	PP$	its
production	NN	production
involves	VBZ	involve
animal	JJ	animal
products	NNS	product
.	SENT	.
Looking	VBG	look
to	TO	to
the	DT	the
future	NN	future
,	,	,
Russell	NP	Russell
predicts	VBZ	predict
a	DT	a
significant	JJ	significant
shift	NN	shift
toward	IN	toward
plant-based	JJ	<unknown>
diets	NNS	diet
,	,	,
driven	VBN	drive
by	IN	by
their	PP$	their
environmental	JJ	environmental
and	CC	and
health	NN	health
benefits	NNS	benefit
.	SENT	.
For	IN	for
anyone	NN	anyone
looking	VBG	look
to	TO	to
start	VB	start
,	,	,
she	PP	she
suggests	VBZ	suggest
simple	JJ	simple
steps	NNS	step
like	IN	like
adding	VBG	add
legumes	NNS	legume
to	TO	to
meals	NNS	meal
and	CC	and
trying	VBG	try
plant	NN	plant
milks	NNS	milk
.	SENT	.
