Humanity	NN	humanity
ignored	VBD	ignore
historical	JJ	historical
warnings	NNS	warning
from	IN	from
thinkers	NNS	thinker
like	IN	like
Malthus	NP	<unknown>
and	CC	and
Mill	NP	Mill
,	,	,
and	CC	and
later	RBR	later
from	IN	from
Paul	NP	Paul
Ehrlich	NP	Ehrlich
's	POS	's
1968	CD	@card@
book	NN	book
"	``	"
The	DT	the
Population	NP	Population
Bomb	NN	bomb
,	,	,
"	''	"
about	IN	about
population	NN	population
growth	NN	growth
exceeding	VBG	exceed
the	DT	the
ecological	JJ	ecological
limits	NNS	limit
of	IN	of
the	DT	the
Earth	NN	earth
.	SENT	.
This	DT	this
has	VBZ	have
led	VBN	lead
to	TO	to
resource	NN	resource
depletion	NN	depletion
,	,	,
the	DT	the
collapse	NN	collapse
of	IN	of
biodiversity	NN	biodiversity
,	,	,
and	CC	and
humanitarian	JJ	humanitarian
crises	NNS	crisis
.	SENT	.
The	DT	the
Green	NP	Green
Revolution	NP	Revolution
,	,	,
in	IN	in
turn	NN	turn
,	,	,
has	VBZ	have
been	VBN	be
critiqued	VBN	<unknown>
for	IN	for
causing	VBG	cause
soil	NN	soil
degradation	NN	degradation
,	,	,
the	DT	the
disruption	NN	disruption
of	IN	of
the	DT	the
nitrogen	NN	nitrogen
cycle	NN	cycle
,	,	,
and	CC	and
contributing	VBG	contribute
to	TO	to
global	JJ	global
heating	NN	heating
.	SENT	.
We	PP	we
are	VBP	be
now	RB	now
facing	VBG	face
the	DT	the
consequences	NNS	consequence
of	IN	of
these	DT	these
issues	NNS	issue
,	,	,
with	IN	with
stagnating	VBG	stagnate
crop	NN	crop
yields	NNS	yield
and	CC	and
declining	VBG	decline
fisheries	NNS	fishery
.	SENT	.
Water	NN	water
scarcity	NN	scarcity
currently	RB	currently
affects	VBZ	affect
850	CD	@card@
million	CD	million
people	NNS	people
.	SENT	.
Furthermore	RB	furthermore
,	,	,
despite	IN	despite
lower	JJR	low
population	NN	population
growth	NN	growth
rates	NNS	rate
,	,	,
malnutrition	NN	malnutrition
is	VBZ	be
on	IN	on
the	DT	the
rise	NN	rise
.	SENT	.
To	TO	to
mitigate	VB	mitigate
ongoing	JJ	ongoing
ecological	JJ	ecological
destruction	NN	destruction
,	,	,
it	PP	it
is	VBZ	be
necessary	JJ	necessary
to	TO	to
address	VB	address
population	NN	population
stabilization	NN	stabilization
and	CC	and
overconsumption	NN	overconsumption
.	SENT	.
Scale	NN	scale
must	MD	must
be	VB	be
recognized	VBN	recognize
as	IN	as
a	DT	a
key	JJ	key
driver	NN	driver
of	IN	of
these	DT	these
environmental	JJ	environmental
problems	NNS	problem
.	SENT	.
