Corporations	NNS	corporation
are	VBP	be
using	VBG	use
tactics	NNS	tactic
known	VBN	know
as	IN	as
SLAPPs	NP	<unknown>
(	(	(
Strategic	NP	Strategic
Lawsuits	NNS	lawsuit
Against	IN	against
Public	NP	Public
Participation	NN	participation
)	)	)
to	TO	to
silence	VB	silence
critics	NNS	critic
with	IN	with
meritless	NN	meritless
lawsuits	NNS	lawsuit
.	SENT	.
Resolute	JJ	resolute
Forest	NP	Forest
Products	NPS	Products
,	,	,
for	IN	for
example	NN	example
,	,	,
filed	VBD	file
a	DT	a
CAD$7	JJ	<unknown>
million	CD	million
suit	NN	suit
in	IN	in
Canada	NP	Canada
against	IN	against
Greenpeace	NP	Greenpeace
Canada	NP	Canada
.	SENT	.
The	DT	the
company	NN	company
also	RB	also
launched	VBD	launch
a	DT	a
CAD$300	NP	<unknown>
million	CD	million
lawsuit	NN	lawsuit
in	IN	in
the	DT	the
U.S.	NP	U.S.
against	IN	against
Greenpeace	NP	Greenpeace
entities	NNS	entity
,	,	,
Stand.earth	NP	Stand.earth
,	,	,
and	CC	and
individuals	NNS	individual
.	SENT	.
This	DT	this
U.S.	NP	U.S.
suit	NN	suit
used	VBN	use
RICO	NP	RICO
laws	NNS	law
to	TO	to
allege	VB	allege
fraud	NN	fraud
.	SENT	.
In	IN	in
another	DT	another
case	NN	case
,	,	,
residents	NNS	resident
of	IN	of
Uniontown	NP	Uniontown
,	,	,
Alabama	NP	Alabama
,	,	,
were	VBD	be
sued	VBN	sue
for	IN	for
USD$30	NP	<unknown>
million	CD	million
over	IN	over
a	DT	a
coal	NN	coal
ash	NN	ash
landfill	NN	landfill
.	SENT	.
With	IN	with
assistance	NN	assistance
from	IN	from
the	DT	the
ACLU	NP	ACLU
,	,	,
they	PP	they
settled	VBD	settle
the	DT	the
case	NN	case
and	CC	and
secured	JJ	secured
better	JJR	good
protections	NNS	protection
.	SENT	.
Despite	IN	despite
the	DT	the
existence	NN	existence
of	IN	of
anti-SLAPP	NP	<unknown>
laws	NNS	law
in	IN	in
some	DT	some
regions	NNS	region
,	,	,
the	DT	the
use	NN	use
of	IN	of
these	DT	these
lawsuits	NNS	lawsuit
is	VBZ	be
on	IN	on
the	DT	the
rise	NN	rise
.	SENT	.
To	TO	to
resist	VB	resist
them	PP	them
,	,	,
the	DT	the
"	``	"
Stand	VBP	stand
FIRM	NN	firm
"	``	"
acronym	NN	acronym
offers	VBZ	offer
a	DT	a
guide	NN	guide
:	:	:
Fight	VB	fight
back	RB	back
,	,	,
Investigate	VB	investigate
,	,	,
Rally	NP	Rally
,	,	,
and	CC	and
Make	VB	make
noise	NN	noise
.	SENT	.
