In	IN	in
2015	CD	@card@
,	,	,
a	DT	a
movement	NN	movement
of	IN	of
seven	CD	seven
million	CD	million
people	NNS	people
helped	VBD	help
halt	VB	halt
Shell	NP	Shell
's	POS	's
plans	NNS	plan
for	IN	for
Arctic	NP	Arctic
expansion	NN	expansion
.	SENT	.
This	DT	this
was	VBD	be
followed	VBN	follow
by	IN	by
the	DT	the
Paris	NP	Paris
climate	NN	climate
agreement	NN	agreement
,	,	,
which	WDT	which
signaled	VBD	signal
a	DT	a
global	JJ	global
shift	NN	shift
away	RB	away
from	IN	from
fossil	JJ	fossil
fuels	NNS	fuel
and	CC	and
towards	IN	towards
a	DT	a
future	NN	future
of	IN	of
sustainability	NN	sustainability
and	CC	and
environmental	JJ	environmental
protection	NN	protection
.	SENT	.
The	DT	the
Arctic	NP	Arctic
,	,	,
however	RB	however
,	,	,
is	VBZ	be
warming	VBG	warm
at	IN	at
twice	RB	twice
the	DT	the
rate	NN	rate
of	IN	of
the	DT	the
rest	NN	rest
of	IN	of
the	DT	the
planet	NN	planet
.	SENT	.
This	DT	this
January	NP	January
saw	VBD	see
a	DT	a
record	NN	record
low	JJ	low
for	IN	for
sea	NN	sea
ice	NN	ice
.	SENT	.
As	IN	as
the	DT	the
ice	NN	ice
melts	VBZ	melt
,	,	,
it	PP	it
is	VBZ	be
enabling	VBG	enable
destructive	JJ	destructive
industrial	JJ	industrial
activity	NN	activity
.	SENT	.
In	IN	in
the	DT	the
Barents	NP	Barents
Sea	NP	Sea
,	,	,
trawlers	NNS	trawler
are	VBP	be
moving	VBG	move
into	IN	into
previously	RB	previously
inaccessible	JJ	inaccessible
areas	NNS	area
,	,	,
risking	VBG	risk
habitats	NNS	habitat
,	,	,
causing	VBG	cause
bycatch	NN	bycatch
,	,	,
and	CC	and
damaging	JJ	damaging
fragile	JJ	fragile
ecosystems	NNS	ecosystem
.	SENT	.
In	IN	in
Norway	NP	Norway
â€™s	POS	's
offshore	JJ	offshore
areas	NNS	area
,	,	,
30-50	CD	@card@
%	NN	%
of	IN	of
coral	JJ	coral
reefs	NNS	reef
have	VBP	have
already	RB	already
been	VBN	be
damaged	VBN	damage
by	IN	by
trawling	VBG	trawl
.	SENT	.
Greenpeace	NP	Greenpeace
investigations	NNS	investigation
at	IN	at
the	DT	the
North	NP	North
Atlantic	NP	Atlantic
Seafood	NN	seafood
Forum	NP	Forum
have	VBP	have
exposed	VBN	expose
the	DT	the
companies	NNS	company
involved	VBD	involve
.	SENT	.
Trawling	VBG	trawl
companies	NNS	company
like	IN	like
Havfisk	NP	<unknown>
ASA	NP	ASA
,	,	,
Ocean	NP	Ocean
Trawlers	NNS	trawler
,	,	,
and	CC	and
FIUN	NP	<unknown>
are	VBP	be
supplying	VBG	supply
processors	NNS	processor
including	VBG	include
Espersen	NP	<unknown>
,	,	,
High	NP	High
Liner	NP	Liner
Foods	NPS	Foods
,	,	,
and	CC	and
Findus	NP	Findus
.	SENT	.
This	DT	this
activity	NN	activity
risks	NNS	risk
tainting	VBG	taint
the	DT	the
supply	NN	supply
chains	NNS	chain
of	IN	of
retailers	NNS	retailer
with	IN	with
Arctic	NP	Arctic
destruction	NN	destruction
.	SENT	.
Please	UH	please
sign	VB	sign
the	DT	the
declaration	NN	declaration
to	TO	to
#savethearctic	JJ	#savethearctic
.	SENT	.
